nghiền	n g h i ề n |
cáy	c á y |
bảo	b ả o |
chó	c h ó |
clohiđric	c l o h i đ r i c |
chội	c h ộ i |
bóng	b ó n g |
kay	k a y |
ngóc	n g ó c |
nhữ	n h ữ |
giũ	g i ũ |
tctđl	t c t đ l |
rào	r à o |
vều	v ề u |
những	n h ữ n g |
mông	m ô n g |
nhấm	n h ấ m |
xuệch	x u ệ c h |
rườn	r ư ờ n |
pula	p u l a |
đâu	đ â u |
đố	đ ố |
cactông	c a c t ô n g |
róng	r ó n g |
rươm	r ư ơ m |
badôca	b a d ô c a |
quệch	q u ệ c h |
tỉnh	t ỉ n h |
ruby	r u b y |
xét	x é t |
lat	l a t |
chạn	c h ạ n |
lăng	l ă n g |
bảu	b ả u |
lột	l ộ t |
rờm	r ờ m |
lẳng	l ẳ n g |
bẹt	b ẹ t |
ôông	ô ô n g |
uýt	u ý t |
bửi	b ử i |
cẳng	c ẳ n g |
dada	d a d a |
rặt	r ặ t |
ruổi	r u ổ i |
rộm	r ộ m |
quấn	q u ấ n |
xoẹ	x o ẹ |
xichlô	x i c h l ô |
cocktail	c o c k t a i l |
tiên	t i ê n |
cobalt	c o b a l t |
oà	o à |
tổ	t ổ |
ỉa	ỉ a |
lưòi	l ư ò i |
rựng	r ự n g |
vie	v i e |
cho	c h o |
lút	l ú t |
nhò	n h ò |
sươi	s ư ơ i |
đặn	đ ặ n |
thõng	t h õ n g |
gồ	g ồ |
trẩy	t r ẩ y |
zloty	z l o t y |
lạnh	l ạ n h |
chưởì	c h ư ở ì |
dồn	d ồ n |
thụ	t h ụ |
chộ	c h ộ |
test	t e s t |
quỷ	q u ỷ |
lọc	l ọ c |
trài	t r à i |
nô	n ô |
pyjama	p y j a m a |
gào	g à o |
lèo	l è o |
nhón	n h ó n |
inôc	i n ô c |
giục	g i ụ c |
xề	x ề |
sung	s u n g |
ngọa	n g ọ a |
canông	c a n ô n g |
ôtômat	ô t ô m a t |
xon	x o n |
trồi	t r ồ i |
cúm	c ú m |
nghệt	n g h ệ t |
thoã	t h o ã |
sả	s ả |
quấc	q u ấ c |
maket	m a k e t |
cùm	c ù m |
mài	m à i |
csdl	c s d l |
gày	g à y |
dọi	d ọ i |
xên	x ê n |
sơ	s ơ |
nghia	n g h i a |
nghía	n g h í a |
thỏa	t h ỏ a |
ngớp	n g ớ p |
tránh	t r á n h |
bă	b ă |
tật	t ậ t |
gieo	g i e o |
anđehit	a n đ e h i t |
thợt	t h ợ t |
tv	t v |
chuyện	c h u y ệ n |
hip	h i p |
quăm	q u ă m |
khậm	k h ậ m |
lạ	l ạ |
dâ	d â |
nu	n u |
gò	g ò |
debian	d e b i a n |
noi	n o i |
lek	l e k |
xỉnh	x ỉ n h |
lẳn	l ẳ n |
trũng	t r ũ n g |
ximôckinh	x i m ô c k i n h |
cụp	c ụ p |
thôi	t h ô i |
ngưng	n g ư n g |
nivô	n i v ô |
soảng	s o ả n g |
vom	v o m |
bic	b i c |
mồng	m ồ n g |
rớt	r ớ t |
tuộc	t u ộ c |
taxi	t a x i |
trạn	t r ạ n |
trết	t r ế t |
vỉa	v ỉ a |
dục	d ụ c |
xuyệt	x u y ệ t |
dăm	d ă m |
sật	s ậ t |
polystyren	p o l y s t y r e n |
trờ	t r ờ |
nỗ	n ỗ |
chằm	c h ằ m |
ỏe	ỏ e |
đoán	đ o á n |
cóp	c ó p |
lenin	l e n i n |
quén	q u é n |
thia	t h i a |
cắm	c ắ m |
nái	n á i |
giẻ	g i ẻ |
euclid	e u c l i d |
khơi	k h ơ i |
cotton	c o t t o n |
tá	t á |
mica	m i c a |
nọt	n ọ t |
gluco	g l u c o |
tẹo	t ẹ o |
lũy	l ũ y |
ngoen	n g o e n |
nhủn	n h ủ n |
vỹ	v ỹ |
clb	c l b |
trò	t r ò |
sản	s ả n |
thủi	t h ủ i |
ai	a i |
nghỉnh	n g h ỉ n h |
xà	x à |
khỏa	k h ỏ a |
bán	b á n |
cặc	c ặ c |
mottj	m o t t j |
quỳnh	q u ỳ n h |
pắc	p ắ c |
thốp	t h ố p |
sị	s ị |
ngàng	n g à n g |
quặng	q u ặ n g |
phận	p h ậ n |
napalm	n a p a l m |
chay	c h a y |
quang	q u a n g |
lếp	l ế p |
dược	d ư ợ c |
pác	p á c |
xẹo	x ẹ o |
trứ	t r ứ |
chề	c h ề |
hởn	h ở n |
tháp	t h á p |
ghệch	g h ệ c h |
thềm	t h ề m |
rồichạy	r ồ i c h ạ y |
are	a r e |
nhất	n h ấ t |
niệm	n i ệ m |
schilling	s c h i l l i n g |
điệp	đ i ệ p |
tểnh	t ể n h |
xám	x á m |
quắt	q u ắ t |
rết	r ế t |
tánh	t á n h |
chéc	c h é c |
nơi	n ơ i |
photphat	p h o t p h a t |
dạm	d ạ m |
beta	b e t a |
lưa	l ư a |
kiê	k i ê |
mầm	m ầ m |
nạn	n ạ n |
quệt	q u ệ t |
tòm	t ò m |
thảm	t h ả m |
nhói	n h ó i |
giập	g i ậ p |
nị	n ị |
nựng	n ự n g |
clanh	c l a n h |
dỉ	d ỉ |
ngoén	n g o é n |
khang	k h a n g |
nhôn	n h ô n |
pẹc	p ẹ c |
truờng	t r u ờ n g |
lari	l a r i |
giôn	g i ô n |
chat	c h a t |
ròn	r ò n |
pheo	p h e o |
kia	k i a |
dẹt	d ẹ t |
giối	g i ố i |
hụ	h ụ |
ngửa	n g ử a |
ờn	ờ n |
đử	đ ử |
duật	d u ậ t |
hủ	h ủ |
quáy	q u á y |
ỉn	ỉ n |
cà	c à |
siêu	s i ê u |
ổ	ổ |
đỗng	đ ỗ n g |
tuốt	t u ố t |
rùm	r ù m |
đai	đ a i |
lào	l à o |
vẻo	v ẻ o |
sọc	s ọ c |
khiu	k h i u |
liệm	l i ệ m |
báy	b á y |
theta	t h e t a |
hượm	h ư ợ m |
lithi	l i t h i |
kêng	k ê n g |
tẩm	t ẩ m |
yuck	y u c k |
nhạt	n h ạ t |
giông	g i ô n g |
pờ	p ờ |
khềnh	k h ề n h |
trôn	t r ô n |
trê	t r ê |
sứa	s ứ a |
sặạt	s ặ ạ t |
rảnh	r ả n h |
đạ	đ ạ |
mưu	m ư u |
dấy	d ấ y |
mớp	m ớ p |
viôlông	v i ô l ô n g |
brao	b r a o |
lử	l ử |
phiêm	p h i ê m |
strychnin	s t r y c h n i n |
tấn	t ấ n |
st	s t |
roạt	r o ạ t |
êta	ê t a |
sucre	s u c r e |
địện	đ ị ệ n |
nhự	n h ự |
hợ	h ợ |
nhon	n h o n |
đầm	đ ầ m |
quoạng	q u o ạ n g |
moayơ	m o a y ơ |
tửa	t ử a |
loạch	l o ạ c h |
nĩa	n ĩ a |
việt	v i ệ t |
chưa	c h ư a |
luýt	l u ý t |
dượt	d ư ợ t |
triềng	t r i ề n g |
nhể	n h ể |
vtv	v t v |
xào	x à o |
khuỷu	k h u ỷ u |
thìu	t h ì u |
khốn	k h ố n |
níp	n í p |
gau	g a u |
sờn	s ờ n |
lăk	l ă k |
chiên	c h i ê n |
ping	p i n g |
tạch	t ạ c h |
xoạt	x o ạ t |
o	o |
phụng	p h ụ n g |
nhõng	n h õ n g |
sài	s à i |
via	v i a |
hao	h a o |
voọc	v o ọ c |
mư	m ư |
bẵng	b ẵ n g |
mọi	m ọ i |
quăng	q u ă n g |
un	u n |
lóm	l ó m |
rà	r à |
cậy	c ậ y |
giồng	g i ồ n g |
khởm	k h ở m |
tướng	t ư ớ n g |
ngũn	n g ũ n |
pham	p h a m |
gại	g ạ i |
streptomycin	s t r e p t o m y c i n |
nguơ	n g u ơ |
cong	c o n g |
quâ	q u â |
sém	s é m |
muồm	m u ồ m |
hỏng	h ỏ n g |
ché	c h é |
vót	v ó t |
xilip	x i l i p |
microfich	m i c r o f i c h |
bao	b a o |
hủó	h ủ ó |
nhân	n h â n |
mốtđường	m ố t đ ư ờ n g |
bởi	b ở i |
thưởng	t h ư ở n g |
hẩy	h ẩ y |
natrium	n a t r i u m |
hùa	h ù a |
hoạnh	h o ạ n h |
khảnh	k h ả n h |
mồm	m ồ m |
thây	t h â y |
dobra	d o b r a |
ênh	ê n h |
proton	p r o t o n |
trống	t r ố n g |
hảnh	h ả n h |
ôliu	ô l i u |
chụm	c h ụ m |
càng	c à n g |
tộc	t ộ c |
doi	d o i |
nạt	n ạ t |
bài	b à i |
giắn	g i ắ n |
oạch	o ạ c h |
béc	b é c |
ken	k e n |
sôn	s ô n |
sâm	s â m |
kệnh	k ệ n h |
sẵắn	s ẵ ắ n |
xoắn	x o ắ n |
thuồi	t h u ồ i |
chia	c h i a |
lực	l ự c |
cs	c s |
rim	r i m |
nhoẹt	n h o ẹ t |
phúc	p h ú c |
thọc	t h ọ c |
xeng	x e n g |
chằn	c h ằ n |
sát	s á t |
mờm	m ờ m |
ké	k é |
tan	t a n |
rạo	r ạ o |
cũi	c ũ i |
lai	l a i |
cướì	c ư ớ ì |
cứa	c ứ a |
hematit	h e m a t i t |
chlorate	c h l o r a t e |
chun	c h u n |
xa	x a |
khơ	k h ơ |
leakage	l e a k a g e |
huỳnh	h u ỳ n h |
nấn	n ấ n |
nông	n ô n g |
ợ	ợ |
nơtrôn	n ơ t r ô n |
ngẩn	n g ẩ n |
uranium	u r a n i u m |
đanh	đ a n h |
chiu	c h i u |
ngóng	n g ó n g |
gặn	g ặ n |
phoi	p h o i |
phosphat	p h o s p h a t |
bậu	b ậ u |
ngoi	n g o i |
mẹc	m ẹ c |
viền	v i ề n |
topo	t o p o |
rang	r a n g |
liễn	l i ễ n |
phớt	p h ớ t |
bloc	b l o c |
dăng	d ă n g |
king	k i n g |
rồicó	r ồ i c ó |
kiệu	k i ệ u |
dỏm	d ỏ m |
lạm	l ạ m |
băng	b ă n g |
mướt	m ư ớ t |
kếp	k ế p |
xít	x í t |
tách	t á c h |
huế	h u ế |
pho	p h o |
sông	s ô n g |
dúng	d ú n g |
cm	c m |
dòng	d ò n g |
mạng	m ạ n g |
patent	p a t e n t |
khoén	k h o é n |
tầng	t ầ n g |
sex	s e x |
nhẫy	n h ẫ y |
mương	m ư ơ n g |
tròn	t r ò n |
kính	k í n h |
đài	đ à i |
bô	b ô |
nạ	n ạ |
quệ	q u ệ |
ngụt	n g ụ t |
hực	h ự c |
bành	b à n h |
ì	ì |
nhâm	n h â m |
ót	ó t |
polime	p o l i m e |
mb	m b |
mịch	m ị c h |
thụi	t h ụ i |
order	o r d e r |
ề	ề |
rũa	r ũ a |
granite	g r a n i t e |
phồng	p h ồ n g |
xọp	x ọ p |
canh	c a n h |
phin	p h i n |
thoả	t h o ả |
toá	t o á |
tichkê	t i c h k ê |
túy	t ú y |
vip	v i p |
ứng	ứ n g |
noel	n o e l |
cur	c u r |
oẳng	o ẳ n g |
giê	g i ê |
ngịu	n g ị u |
óe	ó e |
ộc	ộ c |
thược	t h ư ợ c |
titan	t i t a n |
giống	g i ố n g |
khảm	k h ả m |
nguếch	n g u ế c h |
kin	k i n |
hỉ	h ỉ |
quớt	q u ớ t |
hưng	h ư n g |
xổ	x ổ |
đặng	đ ặ n g |
hòi	h ò i |
kôn	k ô n |
vươn	v ư ơ n |
ram	r a m |
thể	t h ể |
vè	v è |
hơi	h ơ i |
thểu	t h ể u |
choán	c h o á n |
cón	c ó n |
hoằng	h o ằ n g |
dọ	d ọ |
hứng	h ứ n g |
dào	d à o |
đẫy	đ ẫ y |
vực	v ự c |
thùi	t h ù i |
violet	v i o l e t |
vững	v ữ n g |
nhoen	n h o e n |
lổng	l ổ n g |
ttbct	t t b c t |
rồm	r ồ m |
ạt	ạ t |
thồm	t h ồ m |
oán	o á n |
sụt	s ụ t |
bách	b á c h |
troẹt	t r o ẹ t |
đệ	đ ệ |
tuyếc	t u y ế c |
gallery	g a l l e r y |
nhoà	n h o à |
họp	h ọ p |
mê	m ê |
nhồng	n h ồ n g |
hén	h é n |
kẻo	k ẻ o |
fluor	f l u o r |
vàn	v à n |
mittinh	m i t t i n h |
loại	l o ạ i |
dền	d ề n |
consol	c o n s o l |
gạc	g ạ c |
foocmica	f o o c m i c a |
ghe	g h e |
giộ	g i ộ |
nứa	n ứ a |
tăcxi	t ă c x i |
chùa	c h ù a |
trẳng	t r ẳ n g |
xụi	x ụ i |
séo	s é o |
thật	t h ậ t |
đứa	đ ứ a |
granit	g r a n i t |
trói	t r ó i |
nờ	n ờ |
sùm	s ù m |
bợ	b ợ |
dách	d á c h |
đăk	đ ă k |
bonsevich	b o n s e v i c h |
kều	k ề u |
tughrik	t u g h r i k |
thuyền	t h u y ề n |
khiêng	k h i ê n g |
thum	t h u m |
gs	g s |
seaborgi	s e a b o r g i |
tand	t a n d |
nghĩ	n g h ĩ |
idiom	i d i o m |
bẳm	b ẳ m |
gar	g a r |
sờm	s ờ m |
trợtừ	t r ợ t ừ |
râu	r â u |
forint	f o r i n t |
tạng	t ạ n g |
ngỏng	n g ỏ n g |
quyên	q u y ê n |
nườm	n ư ờ m |
mảy	m ả y |
dứ	d ứ |
tỉm	t ỉ m |
ngữ	n g ữ |
bòn	b ò n |
chuế	c h u ế |
vờ	v ờ |
miếc	m i ế c |
nhấn	n h ấ n |
eng	e n g |
kín	k í n |
heo	h e o |
chuồng	c h u ồ n g |
loã	l o ã |
tẹc	t ẹ c |
đẽ	đ ẽ |
dích	d í c h |
dí	d í |
wh	w h |
góa	g ó a |
xín	x í n |
cota	c o t a |
vất	v ấ t |
vại	v ạ i |
giúi	g i ú i |
tel	t e l |
địa	đ ị a |
entropi	e n t r o p i |
ởkhông	ở k h ô n g |
tã	t ã |
giùm	g i ù m |
thòm	t h ò m |
xài	x à i |
rục	r ụ c |
chịu	c h ị u |
rom	r o m |
lững	l ữ n g |
khứa	k h ứ a |
vói	v ó i |
phèn	p h è n |
lướp	l ư ớ p |
nệp	n ệ p |
mnhuộm	m n h u ộ m |
uý	u ý |
zơ	z ơ |
nghàn	n g h à n |
mồi	m ồ i |
phệt	p h ệ t |
loa	l o a |
nhọn	n h ọ n |
nây	n â y |
tân	t â n |
dống	d ố n g |
nha	n h a |
rều	r ề u |
gượm	g ư ợ m |
vitamin	v i t a m i n |
rèn	r è n |
nhang	n h a n g |
kty	k t y |
nhoẻn	n h o ẻ n |
quác	q u á c |
ạo	ạ o |
gamen	g a m e n |
xita	x i t a |
xiết	x i ế t |
xải	x ả i |
đẳng	đ ẳ n g |
ằng	ằ n g |
chuôm	c h u ô m |
kali	k a l i |
đé	đ é |
gói	g ó i |
tướp	t ư ớ p |
đrê	đ r ê |
lc	l c |
gấc	g ấ c |
mổ	m ổ |
phô	p h ô |
mội	m ộ i |
lar	l a r |
kề	k ề |
sạc	s ạ c |
sậu	s ậ u |
rủa	r ủ a |
ohio	o h i o |
nhuệ	n h u ệ |
cách	c á c h |
rat	r a t |
thấp	t h ấ p |
phram	p h r a m |
xin	x i n |
góp	g ó p |
hoai	h o a i |
hít	h í t |
chân	c h â n |
rặc	r ặ c |
tuẫn	t u ẫ n |
hoán	h o á n |
oeo	o e o |
kilôgam	k i l ô g a m |
điều	đ i ề u |
quịt	q u ị t |
điê	đ i ê |
thểnh	t h ể n h |
mười	m ư ờ i |
gủa	g ủ a |
nhụt	n h ụ t |
đuỗn	đ u ỗ n |
axít	a x í t |
xảu	x ả u |
pinh	p i n h |
dyn	d y n |
duộc	d u ộ c |
thâm	t h â m |
cau	c a u |
chom	c h o m |
hẹ	h ẹ |
nạc	n ạ c |
giã	g i ã |
gemani	g e m a n i |
hểnh	h ể n h |
oxi	o x i |
bân	b â n |
quếu	q u ế u |
magneto	m a g n e t o |
lèng	l è n g |
đờn	đ ờ n |
lẩm	l ẩ m |
markka	m a r k k a |
xúng	x ú n g |
banh	b a n h |
lếu	l ế u |
nước	n ư ớ c |
thụp	t h ụ p |
hôm	h ô m |
liễm	l i ễ m |
atropine	a t r o p i n e |
giặc	g i ặ c |
pơmu	p ơ m u |
ếp	ế p |
xuyết	x u y ế t |
tuột	t u ộ t |
bchtw	b c h t w |
trĩ	t r ĩ |
ameriđi	a m e r i đ i |
pronoun	p r o n o u n |
nơtron	n ơ t r o n |
cun	c u n |
nhốn	n h ố n |
đủ	đ ủ |
cấc	c ấ c |
ngoăn	n g o ă n |
chòng	c h ò n g |
hở	h ở |
đăngten	đ ă n g t e n |
im	i m |
phềnh	p h ề n h |
dửng	d ử n g |
ts	t s |
bỏ	b ỏ |
vênh	v ê n h |
tìm	t ì m |
ngoạt	n g o ạ t |
lhq	l h q |
krem	k r e m |
bĩu	b ĩ u |
tết	t ế t |
chắc	c h ắ c |
nhộn	n h ộ n |
nhậu	n h ậ u |
gảy	g ả y |
đệm	đ ệ m |
nhơn	n h ơ n |
ngựa	n g ự a |
cưỡi	c ư ỡ i |
võ	v õ |
visco	v i s c o |
lizin	l i z i n |
bật	b ậ t |
thoắng	t h o ắ n g |
gorilla	g o r i l l a |
chil	c h i l |
kĩn	k ĩ n |
upsilon	u p s i l o n |
hồn	h ồ n |
cầu	c ầ u |
vạp	v ạ p |
xống	x ố n g |
việc	v i ệ c |
atm	a t m |
âu	â u |
thoát	t h o á t |
bốn	b ố n |
glôcôm	g l ô c ô m |
hoảng	h o ả n g |
gươm	g ư ơ m |
nitrate	n i t r a t e |
ưm	ư m |
nõ	n õ |
mựa	m ự a |
đểu	đ ể u |
chửa	c h ử a |
đón	đ ó n |
vắn	v ắ n |
gũi	g ũ i |
lồn	l ồ n |
chìa	c h ì a |
nhổm	n h ổ m |
hoặc	h o ặ c |
lỡm	l ỡ m |
loạt	l o ạ t |
dọt	d ọ t |
queo	q u e o |
xơn	x ơ n |
hẫng	h ẫ n g |
urê	u r ê |
ình	ì n h |
nôen	n ô e n |
khoăm	k h o ă m |
nghẻo	n g h ẻ o |
formica	f o r m i c a |
đập	đ ậ p |
buộm	b u ộ m |
bứt	b ứ t |
nhịp	n h ị p |
miệng	m i ệ n g |
dóa	d ó a |
hứa	h ứ a |
zim	z i m |
ghè	g h è |
nhầu	n h ầ u |
sõng	s õ n g |
tư	t ư |
cồn	c ồ n |
nhà	n h à |
bưởng	b ư ở n g |
quã	q u ã |
xểnh	x ể n h |
heroin	h e r o i n |
viola	v i o l a |
liêu	l i ê u |
xôm	x ô m |
súng	s ú n g |
hoóc	h o ó c |
gabardin	g a b a r d i n |
òm	ò m |
tơì	t ơ ì |
nhứ	n h ứ |
cống	c ố n g |
tụng	t ụ n g |
túi	t ú i |
rát	r á t |
đùi	đ ù i |
mă	m ă |
thắn	t h ắ n |
não	n ã o |
maniven	m a n i v e n |
mono	m o n o |
nghễnh	n g h ễ n h |
chệch	c h ệ c h |
pả	p ả |
véctơ	v é c t ơ |
ngường	n g ư ờ n g |
ghiền	g h i ề n |
roa	r o a |
lit	l i t |
hấu	h ấ u |
thuận	t h u ậ n |
tù	t ù |
eta	e t a |
ởn	ở n |
truyện	t r u y ệ n |
computer	c o m p u t e r |
mằn	m ằ n |
cal	c a l |
tigôn	t i g ô n |
giựt	g i ự t |
nổi	n ổ i |
thoang	t h o a n g |
xè	x è |
rưởi	r ư ở i |
chạm	c h ạ m |
câm	c â m |
duyện	d u y ệ n |
huých	h u ý c h |
oẳnc	o ẳ n c |
dử	d ử |
xuân	x u â n |
nghi	n g h i |
bủ	b ủ |
phiếm	p h i ế m |
ôtôray	ô t ô r a y |
mỳ	m ỳ |
đuồn	đ u ồ n |
khoằm	k h o ằ m |
sưu	s ư u |
reng	r e n g |
vạch	v ạ c h |
kan	k a n |
náp	n á p |
xing	x i n g |
vưỡn	v ư ỡ n |
khúc	k h ú c |
rẫy	r ẫ y |
tôtem	t ô t e m |
môm	m ô m |
etylen	e t y l e n |
xifông	x i f ô n g |
lằng	l ằ n g |
ả	ả |
đởn	đ ở n |
luộm	l u ộ m |
rượi	r ư ợ i |
moan	m o a n |
đớn	đ ớ n |
apphe	a p p h e |
huyết	h u y ế t |
thấy	t h ấ y |
hướng	h ư ớ n g |
chạch	c h ạ c h |
dặn	d ặ n |
luồng	l u ồ n g |
xạp	x ạ p |
hydrochlorur	h y d r o c h l o r u r |
nhóa	n h ó a |
bụp	b ụ p |
nhờ	n h ờ |
trối	t r ố i |
điến	đ i ế n |
axetic	a x e t i c |
rutherfordi	r u t h e r f o r d i |
âm	â m |
zôn	z ô n |
điệt	đ i ệ t |
lủm	l ủ m |
microfilm	m i c r o f i l m |
zin	z i n |
ngoẵng	n g o ẵ n g |
khụng	k h ụ n g |
biđông	b i đ ô n g |
ngão	n g ã o |
dùng	d ù n g |
nhóng	n h ó n g |
thảy	t h ả y |
qúy	q ú y |
version	v e r s i o n |
tóan	t ó a n |
tt	t t |
đồng	đ ồ n g |
õng	õ n g |
sều	s ề u |
ĩ	ĩ |
cứt	c ứ t |
rcăm	r c ă m |
cấp	c ấ p |
hemoglobin	h e m o g l o b i n |
phatxit	p h a t x i t |
dungj	d u n g j |
tử	t ử |
rùn	r ù n |
bến	b ế n |
ẳng	ẳ n g |
nhật	n h ậ t |
ngòng	n g ò n g |
chợ	c h ợ |
thương	t h ư ơ n g |
axetilen	a x e t i l e n |
loát	l o á t |
nhây	n h â y |
nhừa	n h ừ a |
bốnmươi	b ố n m ư ơ i |
chanh	c h a n h |
batê	b a t ê |
tưởng	t ư ở n g |
thuông	t h u ô n g |
nhợn	n h ợ n |
thô	t h ô |
ad	a d |
tứ	t ứ |
toàn	t o à n |
om	o m |
hryvnia	h r y v n i a |
vếch	v ế c h |
trượt	t r ư ợ t |
mẹ	m ẹ |
băn	b ă n |
xệt	x ệ t |
ngỏm	n g ỏ m |
yiddish	y i d d i s h |
dớn	d ớ n |
hôligân	h ô l i g â n |
tủi	t ủ i |
về	v ề |
búa	b ú a |
xơ	x ơ |
gân	g â n |
côngtenơ	c ô n g t e n ơ |
chau	c h a u |
darwin	d a r w i n |
tí	t í |
clorua	c l o r u a |
nhũ	n h ũ |
alphabet	a l p h a b e t |
dóm	d ó m |
lỏi	l ỏ i |
loách	l o á c h |
nẻ	n ẻ |
rịp	r ị p |
khu	k h u |
bựa	b ự a |
gẩy	g ẩ y |
cái	c á i |
glây	g l â y |
hầm	h ầ m |
ngoải	n g o ả i |
sái	s á i |
qh	q h |
môn	m ô n |
tuyệt	t u y ệ t |
nghiu	n g h i u |
ic	i c |
luẩn	l u ẩ n |
phồm	p h ồ m |
xóa	x ó a |
điếu	đ i ế u |
mí	m í |
xái	x á i |
adsl	a d s l |
ghệt	g h ệ t |
nucleon	n u c l e o n |
đận	đ ậ n |
pong	p o n g |
chùy	c h ù y |
eke	e k e |
fomol	f o m o l |
nuốt	n u ố t |
hẵng	h ẵ n g |
loe	l o e |
cỗi	c ỗ i |
cụt	c ụ t |
nhày	n h à y |
hèo	h è o |
dao	d a o |
cắn	c ắ n |
khố	k h ố |
dở	d ở |
suối	s u ố i |
quện	q u ệ n |
gioòng	g i o ò n g |
lira	l i r a |
sùng	s ù n g |
dim	d i m |
pết	p ế t |
phát	p h á t |
do	d o |
cedi	c e d i |
cơ	c ơ |
cour	c o u r |
trăng	t r ă n g |
sảng	s ả n g |
ladơn	l a d ơ n |
kilobyte	k i l o b y t e |
lấu	l ấ u |
dynamite	d y n a m i t e |
rễ	r ễ |
mđhur	m đ h u r |
apatit	a p a t i t |
albumin	a l b u m i n |
xuồng	x u ồ n g |
thuốt	t h u ố t |
tốt	t ố t |
armonica	a r m o n i c a |
đừa	đ ừ a |
côống	c ô ố n g |
dờn	d ờ n |
thào	t h à o |
nứt	n ứ t |
tớp	t ớ p |
đục	đ ụ c |
cuối	c u ố i |
mích	m í c h |
bươm	b ư ơ m |
chện	c h ệ n |
đuờng	đ u ờ n g |
sìn	s ì n |
ngươi	n g ư ơ i |
silic	s i l i c |
giảm	g i ả m |
kwacha	k w a c h a |
thừa	t h ừ a |
tupsa	t u p s a |
duốc	d u ố c |
hô	h ô |
lòe	l ò e |
nhử	n h ử |
bichquy	b i c h q u y |
xten	x t e n |
dũ	d ũ |
bữa	b ữ a |
nghỉu	n g h ỉ u |
lọ	l ọ |
sic	s i c |
nộ	n ộ |
kheo	k h e o |
xôviêt	x ô v i ê t |
vệ	v ệ |
arbit	a r b i t |
ních	n í c h |
lía	l í a |
amib	a m i b |
xát	x á t |
trâng	t r â n g |
rình	r ì n h |
methane	m e t h a n e |
circuit	c i r c u i t |
cân	c â n |
tríu	t r í u |
dáo	d á o |
đoan	đ o a n |
vali	v a l i |
phó	p h ó |
nén	n é n |
tcty	t c t y |
chiếc	c h i ế c |
đoản	đ o ả n |
sọm	s ọ m |
dgieh	d g i e h |
cornwall	c o r n w a l l |
xỉ	x ỉ |
cô	c ô |
methoxy	m e t h o x y |
pêđan	p ê đ a n |
solenoid	s o l e n o i d |
xụp	x ụ p |
cường	c ư ờ n g |
bửa	b ử a |
xim	x i m |
hoay	h o a y |
rôti	r ô t i |
marxit	m a r x i t |
trackpad	t r a c k p a d |
tòron	t ò r o n |
kìa	k ì a |
oác	o á c |
ngủi	n g ủ i |
riếu	r i ế u |
vợt	v ợ t |
bầy	b ầ y |
nom	n o m |
chượp	c h ư ợ p |
loăn	l o ă n |
nhâng	n h â n g |
ẻn	ẻ n |
síc	s í c |
xùa	x ù a |
siễn	s i ễ n |
gấu	g ấ u |
háo	h á o |
cuội	c u ộ i |
giắm	g i ắ m |
nền	n ề n |
hụi	h ụ i |
ẹt	ẹ t |
gôrila	g ô r i l a |
giằm	g i ằ m |
trơi	t r ơ i |
vinylon	v i n y l o n |
nuy	n u y |
mút	m ú t |
né	n é |
quẳng	q u ẳ n g |
chược	c h ư ợ c |
lạng	l ạ n g |
ván	v á n |
vụn	v ụ n |
kèn	k è n |
huỡn	h u ỡ n |
tố	t ố |
điêng	đ i ê n g |
tốp	t ố p |
luy	l u y |
xýt	x ý t |
positron	p o s i t r o n |
đăng	đ ă n g |
lũi	l ũ i |
lơgo	l ơ g o |
gường	g ư ờ n g |
chảo	c h ả o |
nạm	n ạ m |
khoạng	k h o ạ n g |
quéo	q u é o |
luý	l u ý |
ậm	ậ m |
bit	b i t |
đàn	đ à n |
chêm	c h ê m |
ghịt	g h ị t |
trui	t r u i |
nhọ	n h ọ |
tácdự	t á c d ự |
ngợi	n g ợ i |
thảnh	t h ả n h |
nhũn	n h ũ n |
vịt	v ị t |
thá	t h á |
pốt	p ố t |
lớn	l ớ n |
mầy	m ầ y |
xảnh	x ả n h |
khuâng	k h u â n g |
lúa	l ú a |
khuờ	k h u ờ |
thiềm	t h i ề m |
lộng	l ộ n g |
inh	i n h |
dẹm	d ẹ m |
bata	b a t a |
hái	h á i |
ơ	ơ |
xùi	x ù i |
chỏm	c h ỏ m |
totem	t o t e m |
colon	c o l o n |
má	m á |
ngận	n g ậ n |
pao	p a o |
xia	x i a |
gacđiêng	g a c đ i ê n g |
chơm	c h ơ m |
bểnh	b ể n h |
dù	d ù |
mom	m o m |
rướm	r ư ớ m |
bất	b ấ t |
tẩn	t ẩ n |
chữa	c h ữ a |
há	h á |
đợi	đ ợ i |
bulgari	b u l g a r i |
caolanh	c a o l a n h |
accordeon	a c c o r d e o n |
điezen	đ i e z e n |
nệm	n ệ m |
rốt	r ố t |
bida	b i d a |
bống	b ố n g |
pizza	p i z z a |
roto	r o t o |
w	w |
thí	t h í |
giằng	g i ằ n g |
nầy	n ầ y |
hormone	h o r m o n e |
sảnh	s ả n h |
triến	t r i ế n |
ghém	g h é m |
sun	s u n |
rân	r â n |
anod	a n o d |
ste	s t e |
ruồi	r u ồ i |
hênh	h ê n h |
gọng	g ọ n g |
cuộng	c u ộ n g |
mẹp	m ẹ p |
tút	t ú t |
bứu	b ứ u |
alkaloid	a l k a l o i d |
trần	t r ầ n |
hiệu	h i ệ u |
đam	đ a m |
nự	n ự |
váng	v á n g |
điệnbắt	đ i ệ n b ắ t |
mạc	m ạ c |
vát	v á t |
vía	v í a |
rái	r á i |
pó	p ó |
bỉm	b ỉ m |
khiên	k h i ê n |
coong	c o o n g |
quạu	q u ạ u |
liềng	l i ề n g |
bấy	b ấ y |
lật	l ậ t |
náy	n á y |
tlộm	t l ộ m |
ngáp	n g á p |
nic	n i c |
oăm	o ă m |
oi	o i |
ươn	ư ơ n |
acetone	a c e t o n e |
tẫn	t ẫ n |
continum	c o n t i n u m |
nem	n e m |
mướn	m ư ớ n |
kuênh	k u ê n h |
nhểu	n h ể u |
tinh	t i n h |
trọi	t r ọ i |
bở	b ở |
tụt	t ụ t |
phắn	p h ắ n |
diêm	d i ê m |
mền	m ề n |
trương	t r ư ơ n g |
ruốc	r u ố c |
máo	m á o |
ác	á c |
mỏm	m ỏ m |
bông	b ô n g |
đình	đ ì n h |
trửng	t r ử n g |
money	m o n e y |
ea	e a |
chịsáu	c h ị s á u |
rốn	r ố n |
sigma	s i g m a |
yô	y ô |
khuỵ	k h u ỵ |
chỏn	c h ỏ n |
khập	k h ậ p |
ôvăng	ô v ă n g |
phún	p h ú n |
đui	đ u i |
compa	c o m p a |
mps	m p s |
thang	t h a n g |
thừ	t h ừ |
iai	i a i |
mega	m e g a |
gạch	g ạ c h |
trô	t r ô |
sút	s ú t |
tênh	t ê n h |
hợt	h ợ t |
cẳn	c ẳ n |
b	b |
chuột	c h u ộ t |
chũm	c h ũ m |
páp	p á p |
gioăng	g i o ă n g |
khửng	k h ử n g |
ngậm	n g ậ m |
thuế	t h u ế |
pittông	p i t t ô n g |
ngun	n g u n |
thiều	t h i ề u |
gạo	g ạ o |
đó	đ ó |
prô	p r ô |
abc	a b c |
đá	đ á |
gluxit	g l u x i t |
tipô	t i p ô |
paraguay	p a r a g u a y |
bombê	b o m b ê |
đeng	đ e n g |
thắt	t h ắ t |
chơn	c h ơ n |
thêta	t h ê t a |
đội	đ ộ i |
nỏi	n ỏ i |
ốp	ố p |
cháy	c h á y |
fibroximăng	f i b r o x i m ă n g |
nho	n h o |
manhetit	m a n h e t i t |
thui	t h u i |
kitô	k i t ô |
khoắt	k h o ắ t |
khuất	k h u ấ t |
ôtôbuýt	ô t ô b u ý t |
vẫy	v ẫ y |
khoé	k h o é |
tía	t í a |
thuật	t h u ậ t |
vống	v ố n g |
pông	p ô n g |
va	v a |
mứu	m ứ u |
mía	m í a |
chấu	c h ấ u |
trức	t r ứ c |
tắt	t ắ t |
cơlê	c ơ l ê |
rốc	r ố c |
thạch	t h ạ c h |
tợ	t ợ |
xoảng	x o ả n g |
toản	t o ả n |
pánh	p á n h |
nguỳ	n g u ỳ |
xui	x u i |
phục	p h ụ c |
hoáy	h o á y |
dợ	d ợ |
xoành	x o à n h |
bẫm	b ẫ m |
kiên	k i ê n |
rađian	r a đ i a n |
harmonica	h a r m o n i c a |
cọng	c ọ n g |
mụt	m ụ t |
ẻo	ẻ o |
đíp	đ í p |
thàng	t h à n g |
y	y |
giành	g i à n h |
rểnh	r ể n h |
manơcanh	m a n ơ c a n h |
me	m e |
đạt	đ ạ t |
gỉ	g ỉ |
hoà	h o à |
bơn	b ơ n |
sinh	s i n h |
ngộn	n g ộ n |
đivăng	đ i v ă n g |
cưng	c ư n g |
kiếp	k i ế p |
phặng	p h ặ n g |
won	w o n |
vích	v í c h |
luống	l u ố n g |
phước	p h ư ớ c |
binđinh	b i n đ i n h |
luật	l u ậ t |
sđd	s đ d |
múa	m ú a |
gợt	g ợ t |
lắk	l ắ k |
bowling	b o w l i n g |
sụp	s ụ p |
kangaroo	k a n g a r o o |
êpan	ê p a n |
sệp	s ệ p |
vòmg	v ò m g |
nù	n ù |
san	s a n |
hydrogen	h y d r o g e n |
hột	h ộ t |
công	c ô n g |
rooi	r o o i |
mattit	m a t t i t |
nọn	n ọ n |
mèng	m è n g |
bấng	b ấ n g |
đt	đ t |
vài	v à i |
kilobit	k i l o b i t |
diều	d i ề u |
bịn	b ị n |
chiềng	c h i ề n g |
nhương	n h ư ơ n g |
dỗi	d ỗ i |
bổi	b ổ i |
email	e m a i l |
tấp	t ấ p |
phệu	p h ệ u |
diệm	d i ệ m |
gothic	g o t h i c |
jean	j e a n |
thời	t h ờ i |
quẽ	q u ẽ |
gườm	g ư ờ m |
luỗng	l u ỗ n g |
ngủ	n g ủ |
rầu	r ầ u |
hắng	h ắ n g |
bênh	b ê n h |
xờ	x ờ |
ắng	ắ n g |
mỉ	m ỉ |
balboa	b a l b o a |
ăngten	ă n g t e n |
coóc	c o ó c |
môtip	m ô t i p |
bựng	b ự n g |
chẹt	c h ẹ t |
ạ	ạ |
dện	d ệ n |
lủng	l ủ n g |
electron	e l e c t r o n |
miền	m i ề n |
ngụa	n g ụ a |
chlorure	c h l o r u r e |
ke	k e |
thịu	t h ị u |
kilowatt	k i l o w a t t |
ă	ă |
wushu	w u s h u |
ực	ự c |
toáng	t o á n g |
mình	m ì n h |
luốt	l u ố t |
vèn	v è n |
ngang	n g a n g |
nẩm	n ẩ m |
ọt	ọ t |
dêrô	d ê r ô |
tầu	t ầ u |
violoncello	v i o l o n c e l l o |
đoàng	đ o à n g |
dùi	d ù i |
xịn	x ị n |
chẳng	c h ẳ n g |
bạng	b ạ n g |
vacxin	v a c x i n |
frăng	f r ă n g |
đặm	đ ặ m |
clay	c l a y |
tẻo	t ẻ o |
bố	b ố |
lần	l ầ n |
trấu	t r ấ u |
rị	r ị |
xúm	x ú m |
lãng	l ã n g |
ghẹo	g h ẹ o |
ktul	k t u l |
hay	h a y |
kềnh	k ề n h |
suplơ	s u p l ơ |
quép	q u é p |
òn	ò n |
ử	ử |
thường	t h ư ờ n g |
ứ	ứ |
xanh	x a n h |
prông	p r ô n g |
chảu	c h ả u |
đù	đ ù |
dứng	d ứ n g |
trút	t r ú t |
bổn	b ổ n |
nhoè	n h o è |
ngón	n g ó n |
rúp	r ú p |
nhẩu	n h ẩ u |
đăm	đ ă m |
tuyền	t u y ề n |
ăccoóc	ă c c o ó c |
giò	g i ò |
láy	l á y |
dýn	d ý n |
thốc	t h ố c |
rai	r a i |
lóp	l ó p |
fuy	f u y |
bực	b ự c |
trạch	t r ạ c h |
ăn	ă n |
batinê	b a t i n ê |
khọt	k h ọ t |
đeo	đ e o |
hợm	h ợ m |
giấn	g i ấ n |
hấn	h ấ n |
ơinó	ơ i n ó |
kiềm	k i ề m |
gẫu	g ẫ u |
consortium	c o n s o r t i u m |
trộc	t r ộ c |
đrích	đ r í c h |
đuông	đ u ô n g |
basoi	b a s o i |
calcium	c a l c i u m |
đĩa	đ ĩ a |
vo	v o |
tuốn	t u ố n |
thện	t h ệ n |
cớ	c ớ |
rất	r ấ t |
bảy	b ả y |
ép	é p |
bớn	b ớ n |
pop	p o p |
macma	m a c m a |
người	n g ư ờ i |
kịt	k ị t |
rợm	r ợ m |
rè	r è |
bios	b i o s |
cỡn	c ỡ n |
soàm	s o à m |
chai	c h a i |
con	c o n |
ngật	n g ậ t |
lười	l ư ờ i |
lão	l ã o |
tận	t ậ n |
giắc	g i ắ c |
mạn	m ạ n |
chổng	c h ổ n g |
toa	t o a |
noun	n o u n |
đốt	đ ố t |
chum	c h u m |
phấp	p h ấ p |
khoét	k h o é t |
phét	p h é t |
dọng	d ọ n g |
photo	p h o t o |
ngoẻm	n g o ẻ m |
ngoàm	n g o à m |
ngoao	n g o a o |
bấm	b ấ m |
rui	r u i |
diếu	d i ế u |
tát	t á t |
chuyền	c h u y ề n |
bấu	b ấ u |
xằng	x ằ n g |
loẹt	l o ẹ t |
đặc	đ ặ c |
mởn	m ở n |
khạo	k h ạ o |
nẹ	n ẹ |
nhoài	n h o à i |
dé	d é |
din	d i n |
đólà	đ ó l à |
quều	q u ề u |
cu	c u |
lưỡi	l ư ỡ i |
bục	b ụ c |
nguồi	n g u ồ i |
khú	k h ú |
nghê	n g h ê |
châm	c h â m |
nau	n a u |
quẹn	q u ẹ n |
cửa	c ử a |
đia	đ i a |
ịt	ị t |
nhủng	n h ủ n g |
ẵm	ẵ m |
cỏn	c ỏ n |
trắt	t r ắ t |
may	m a y |
trệt	t r ệ t |
blăng	b l ă n g |
cắp	c ắ p |
chẹn	c h ẹ n |
triệt	t r i ệ t |
dối	d ố i |
giúc	g i ú c |
ruble	r u b l e |
câng	c â n g |
rơ	r ơ |
ĩnh	ĩ n h |
quãng	q u ã n g |
phơi	p h ơ i |
sồn	s ồ n |
ê	ê |
watt	w a t t |
pli	p l i |
quì	q u ì |
ephedrin	e p h e d r i n |
nánh	n á n h |
chảnh	c h ả n h |
ức	ứ c |
lạị	l ạ ị |
album	a l b u m |
trộng	t r ộ n g |
pào	p à o |
cành	c à n h |
roentgen	r o e n t g e n |
rẵng	r ẵ n g |
gãy	g ã y |
ngư	n g ư |
khớp	k h ớ p |
mẽ	m ẽ |
radian	r a d i a n |
nghênh	n g h ê n h |
trụn	t r ụ n |
office	o f f i c e |
nọ	n ọ |
ether	e t h e r |
vanilla	v a n i l l a |
nêông	n ê ô n g |
đờm	đ ờ m |
xó	x ó |
nướng	n ư ớ n g |
apacthai	a p a c t h a i |
hụp	h ụ p |
nằn	n ằ n |
rho	r h o |
ptth	p t t h |
gặp	g ặ p |
mun	m u n |
hãm	h ã m |
oai	o a i |
nghiệt	n g h i ệ t |
mìu	m ì u |
rặng	r ặ n g |
thờ	t h ờ |
chệt	c h ệ t |
ngấy	n g ấ y |
gb	g b |
dáu	d á u |
đuội	đ u ộ i |
cưới	c ư ớ i |
phứa	p h ứ a |
khỉnh	k h ỉ n h |
lôcôt	l ô c ô t |
thám	t h á m |
thảẳm	t h ả ẳ m |
giộp	g i ộ p |
ừm	ừ m |
giốc	g i ố c |
gâu	g â u |
luyên	l u y ê n |
xuộm	x u ộ m |
bàng	b à n g |
kw	k w |
kẽ	k ẽ |
bua	b u a |
xolenoit	x o l e n o i t |
ngoa	n g o a |
ngấn	n g ấ n |
còng	c ò n g |
húi	h ú i |
lích	l í c h |
clorat	c l o r a t |
xay	x a y |
phụp	p h ụ p |
nhăm	n h ă m |
bôn	b ô n |
khiểng	k h i ể n g |
tụ	t ụ |
mm	m m |
biếm	b i ế m |
phăng	p h ă n g |
ngốt	n g ố t |
lết	l ế t |
ngoáo	n g o á o |
mất	m ấ t |
nẹt	n ẹ t |
lủa	l ủ a |
sít	s í t |
caravat	c a r a v a t |
rôn	r ô n |
giỏng	g i ỏ n g |
thới	t h ớ i |
ngãng	n g ã n g |
tulơkhơ	t u l ơ k h ơ |
gậm	g ậ m |
xồ	x ồ |
nơron	n ơ r o n |
platin	p l a t i n |
ngấc	n g ấ c |
symposium	s y m p o s i u m |
năng	n ă n g |
nhiu	n h i u |
keng	k e n g |
bích	b í c h |
khoào	k h o à o |
tracom	t r a c o m |
stê	s t ê |
cc	c c |
điểm	đ i ể m |
varactor	v a r a c t o r |
ngánh	n g á n h |
metical	m e t i c a l |
muô	m u ô |
lổ	l ổ |
giun	g i u n |
lỡ	l ỡ |
đu	đ u |
sập	s ậ p |
cài	c à i |
đấng	đ ấ n g |
nhốt	n h ố t |
ním	n í m |
thính	t h í n h |
nhếu	n h ế u |
vằng	v ằ n g |
ngơi	n g ơ i |
chcc	c h c c |
đễ	đ ễ |
mạt	m ạ t |
long	l o n g |
têtanôt	t ê t a n ô t |
oành	o à n h |
bịt	b ị t |
sỗ	s ỗ |
cẵng	c ẵ n g |
hặm	h ặ m |
đệp	đ ệ p |
đẵm	đ ẵ m |
khư	k h ư |
thín	t h í n |
polyvitamin	p o l y v i t a m i n |
chặn	c h ặ n |
xai	x a i |
chõ	c h õ |
vaccin	v a c c i n |
t	t |
bỡn	b ỡ n |
chạt	c h ạ t |
candela	c a n d e l a |
chóe	c h ó e |
tọ	t ọ |
ngoằng	n g o ằ n g |
chầy	c h ầ y |
este	e s t e |
đuểnh	đ u ể n h |
nơ	n ơ |
phăm	p h ă m |
mẳn	m ẳ n |
phí	p h í |
nốt	n ố t |
mức	m ứ c |
nhoằng	n h o ằ n g |
hoại	h o ạ i |
chài	c h à i |
vọi	v ọ i |
lêc	l ê c |
đợt	đ ợ t |
phủng	p h ủ n g |
lợ	l ợ |
kiếm	k i ế m |
nhì	n h ì |
crêp	c r ê p |
ìn	ì n |
nhúm	n h ú m |
ôxi	ô x i |
nhiên	n h i ê n |
buốc	b u ố c |
tác	t á c |
giơ	g i ơ |
dờ	d ờ |
vettông	v e t t ô n g |
múi	m ú i |
khem	k h e m |
thèm	t h è m |
giếm	g i ế m |
ngởn	n g ở n |
nhâp	n h â p |
ngultrum	n g u l t r u m |
chúi	c h ú i |
lạch	l ạ c h |
choảng	c h o ả n g |
ngãi	n g ã i |
đãi	đ ã i |
đắn	đ ắ n |
nhòm	n h ò m |
amygdala	a m y g d a l a |
bùng	b ù n g |
loạn	l o ạ n |
lưc	l ư c |
mùi	m ù i |
bình	b ì n h |
nú	n ú |
biến	b i ế n |
hũm	h ũ m |
lạy	l ạ y |
trôi	t r ô i |
đười	đ ư ờ i |
florida	f l o r i d a |
khỏi	k h ỏ i |
stator	s t a t o r |
lụy	l ụ y |
hến	h ế n |
tràu	t r à u |
xỏng	x ỏ n g |
trãi	t r ã i |
ii	i i |
khoá	k h o á |
đủng	đ ủ n g |
bỉnh	b ỉ n h |
ub	u b |
aspirin	a s p i r i n |
nhớp	n h ớ p |
nguồn	n g u ồ n |
alô	a l ô |
tiển	t i ể n |
rõ	r õ |
antraxit	a n t r a x i t |
mĩ	m ĩ |
cọn	c ọ n |
vôi	v ô i |
xối	x ố i |
chuối	c h u ố i |
vội	v ộ i |
laze	l a z e |
khúm	k h ú m |
trọc	t r ọ c |
chà	c h à |
đạc	đ ạ c |
năn	n ă n |
gầy	g ầ y |
say	s a y |
lô	l ô |
điềm	đ i ề m |
lẻ	l ẻ |
kèm	k è m |
sề	s ề |
ôboa	ô b o a |
chưởng	c h ư ở n g |
rỡn	r ỡ n |
lảu	l ả u |
nét	n é t |
cẩy	c ẩ y |
sọt	s ọ t |
néo	n é o |
elip	e l i p |
hiđro	h i đ r o |
sắm	s ắ m |
bêrê	b ê r ê |
miễu	m i ễ u |
xự	x ự |
anthracit	a n t h r a c i t |
niên	n i ê n |
váo	v á o |
chái	c h á i |
xồn	x ồ n |
măngđôlin	m ă n g đ ô l i n |
lập	l ậ p |
nghinh	n g h i n h |
thầu	t h ầ u |
bời	b ờ i |
hẹt	h ẹ t |
lén	l é n |
hủy	h ủ y |
nhen	n h e n |
muy	m u y |
chếnh	c h ế n h |
húm	h ú m |
xóp	x ó p |
loác	l o á c |
soóc	s o ó c |
nhứt	n h ứ t |
trưởng	t r ư ở n g |
pháp	p h á p |
cavat	c a v a t |
chải	c h ả i |
nhàu	n h à u |
megabit	m e g a b i t |
choèn	c h o è n |
pemanganat	p e m a n g a n a t |
hyđrô	h y đ r ô |
khè	k h è |
catôt	c a t ô t |
khám	k h á m |
hử	h ử |
vởn	v ở n |
luyn	l u y n |
khẩm	k h ẩ m |
nghiệp	n g h i ệ p |
kệch	k ệ c h |
include	i n c l u d e |
quắn	q u ắ n |
gỏl	g ỏ l |
khìn	k h ì n |
đượn	đ ư ợ n |
nư	n ư |
platine	p l a t i n e |
phim	p h i m |
bazơ	b a z ơ |
mayso	m a y s o |
kết	k ế t |
buốt	b u ố t |
nhing	n h i n g |
rành	r à n h |
ngườí	n g ư ờ í |
mườinhà	m ư ờ i n h à |
commăng	c o m m ă n g |
dại	d ạ i |
nhuỵ	n h u ỵ |
hãng	h ã n g |
khiếu	k h i ế u |
sí	s í |
khươm	k h ư ơ m |
bon	b o n |
chép	c h é p |
wolfram	w o l f r a m |
pẻ	p ẻ |
khén	k h é n |
vuột	v u ộ t |
nịnh	n ị n h |
ngừng	n g ừ n g |
păng	p ă n g |
trính	t r í n h |
tằn	t ằ n |
kinh	k i n h |
puốcboa	p u ố c b o a |
tẳn	t ẳ n |
url	u r l |
rưa	r ư a |
tồi	t ồ i |
bảng	b ả n g |
mốc	m ố c |
khiếm	k h i ế m |
phác	p h á c |
lõ	l õ |
khoèo	k h o è o |
ngai	n g a i |
xao	x a o |
xẻ	x ẻ |
mưng	m ư n g |
gật	g ậ t |
meson	m e s o n |
casino	c a s i n o |
tủa	t ủ a |
tâng	t â n g |
đểnh	đ ể n h |
mua	m u a |
rạc	r ạ c |
drăng	d r ă n g |
kiệm	k i ệ m |
nhánh	n h á n h |
muộn	m u ộ n |
tba	t b a |
mo	m o |
nhích	n h í c h |
chây	c h â y |
phụ	p h ụ |
bốt	b ố t |
fu	f u |
chót	c h ó t |
franc	f r a n c |
sặc	s ặ c |
moóc	m o ó c |
lợt	l ợ t |
xụng	x ụ n g |
hệ	h ệ |
vẹo	v ẹ o |
nộp	n ộ p |
giổi	g i ổ i |
sượng	s ư ợ n g |
í	í |
gối	g ố i |
lẻn	l ẻ n |
khảo	k h ả o |
lẽn	l ẽ n |
gáy	g á y |
ho	h o |
krona	k r o n a |
hỗn	h ỗ n |
choe	c h o e |
phình	p h ì n h |
lưỡng	l ư ỡ n g |
côtang	c ô t a n g |
muya	m u y a |
mũi	m ũ i |
cellulos	c e l l u l o s |
từa	t ừ a |
rò	r ò |
muống	m u ố n g |
tràm	t r à m |
khoát	k h o á t |
sờ	s ờ |
quốc	q u ố c |
quần	q u ầ n |
sol	s o l |
sệt	s ệ t |
giày	g i à y |
aỏi	a ỏ i |
ngọt	n g ọ t |
bịu	b ị u |
vận	v ậ n |
hun	h u n |
bung	b u n g |
gá	g á |
phòm	p h ò m |
phè	p h è |
rây	r â y |
nhạnh	n h ạ n h |
khạp	k h ạ p |
dấu	d ấ u |
xõa	x õ a |
hậu	h ậ u |
nhần	n h ầ n |
xích	x í c h |
bể	b ể |
chửi	c h ử i |
lặt	l ặ t |
hết	h ế t |
phéc	p h é c |
bungari	b u n g a r i |
khắp	k h ắ p |
mách	m á c h |
xếch	x ế c h |
vam	v a m |
hiện	h i ệ n |
chuỗi	c h u ỗ i |
đơ	đ ơ |
amiant	a m i a n t |
phủ	p h ủ |
mồ	m ồ |
thỉnh	t h ỉ n h |
ập	ậ p |
ngoai	n g o a i |
hiđrocacbon	h i đ r o c a c b o n |
krôm	k r ô m |
tolar	t o l a r |
toại	t o ạ i |
mời	m ờ i |
ve	v e |
internet	i n t e r n e t |
ngảnh	n g ả n h |
dliê	d l i ê |
ngỏ	n g ỏ |
rũ	r ũ |
lạn	l ạ n |
chín	c h í n |
marxist	m a r x i s t |
đẩn	đ ẩ n |
đế	đ ế |
d	d |
ngũng	n g ũ n g |
trộn	t r ộ n |
tượng	t ư ợ n g |
tê	t ê |
đinamit	đ i n a m i t |
beo	b e o |
rạch	r ạ c h |
truyền	t r u y ề n |
chọi	c h ọ i |
anten	a n t e n |
nhụng	n h ụ n g |
khòm	k h ò m |
nhẩn	n h ẩ n |
phưỡn	p h ư ỡ n |
hội	h ộ i |
lờn	l ờ n |
tréc	t r é c |
thếp	t h ế p |
sườn	s ư ờ n |
táo	t á o |
ap	a p |
nhô	n h ô |
bang	b a n g |
thưỡi	t h ư ỡ i |
chậm	c h ậ m |
díu	d í u |
hiđroclorua	h i đ r o c l o r u a |
nhăn	n h ă n |
đêximét	đ ê x i m é t |
lựa	l ự a |
ầy	ầ y |
khưỡng	k h ư ỡ n g |
péo	p é o |
gộc	g ộ c |
bím	b í m |
đụn	đ ụ n |
phút	p h ú t |
ện	ệ n |
benzene	b e n z e n e |
xướng	x ư ớ n g |
vày	v à y |
nhận	n h ậ n |
điển	đ i ể n |
usd	u s d |
rến	r ế n |
chạc	c h ạ c |
vú	v ú |
quày	q u à y |
trâu	t r â u |
nhuận	n h u ậ n |
kilô	k i l ô |
đạo	đ ạ o |
thiếp	t h i ế p |
thóm	t h ó m |
rắm	r ắ m |
tọa	t ọ a |
cửi	c ử i |
rôcket	r ô c k e t |
ếm	ế m |
vằm	v ằ m |
khịa	k h ị a |
mlời	m l ờ i |
spi	s p i |
xôn	x ô n |
xáu	x á u |
campanagara	c a m p a n a g a r a |
bốc	b ố c |
mực	m ự c |
mâu	m â u |
nghèo	n g h è o |
đới	đ ớ i |
lữ	l ữ |
nghịch	n g h ị c h |
nỗng	n ỗ n g |
tụm	t ụ m |
lỏm	l ỏ m |
hiếc	h i ế c |
nẳm	n ẳ m |
win	w i n |
phạn	p h ạ n |
trỗ	t r ỗ |
tri	t r i |
chác	c h á c |
nhạu	n h ạ u |
rổ	r ổ |
gallon	g a l l o n |
mophin	m o p h i n |
ban	b a n |
mé	m é |
granito	g r a n i t o |
ngẩng	n g ẩ n g |
nhủ	n h ủ |
khăn	k h ă n |
xực	x ự c |
thếch	t h ế c h |
bướu	b ư ớ u |
nhòa	n h ò a |
hộn	h ộ n |
bĩnh	b ĩ n h |
đóng	đ ó n g |
tiểu	t i ể u |
cảo	c ả o |
nhe	n h e |
giỏ	g i ỏ |
man	m a n |
đùng	đ ù n g |
trệu	t r ệ u |
nử	n ử |
lý	l ý |
dắt	d ắ t |
nưng	n ư n g |
ủa	ủ a |
mòi	m ò i |
xáng	x á n g |
kháy	k h á y |
ky	k y |
phuồm	p h u ồ m |
thin	t h i n |
hôi	h ô i |
roi	r o i |
hiển	h i ể n |
liếc	l i ế c |
ki	k i |
hạn	h ạ n |
sạm	s ạ m |
sệch	s ệ c h |
hổm	h ổ m |
cấy	c ấ y |
thênh	t h ê n h |
crông	c r ô n g |
quích	q u í c h |
khảy	k h ả y |
gà	g à |
đrô	đ r ô |
đóp	đ ó p |
sẻ	s ẻ |
ngẫm	n g ẫ m |
riềng	r i ề n g |
oắt	o ắ t |
chộn	c h ộ n |
sữa	s ữ a |
supde	s u p d e |
tăng	t ă n g |
chột	c h ộ t |
x	x |
khĩnh	k h ĩ n h |
lợp	l ợ p |
chứt	c h ứ t |
kpăng	k p ă n g |
ktlê	k t l ê |
ăng	ă n g |
bàu	b à u |
quýnh	q u ý n h |
dừng	d ừ n g |
sẹc	s ẹ c |
lev	l e v |
hoác	h o á c |
dom	d o m |
kh	k h |
duồn	d u ồ n |
hổi	h ổ i |
nhởn	n h ở n |
khục	k h ụ c |
kẻ	k ẻ |
card	c a r d |
hoẹ	h o ẹ |
cathod	c a t h o d |
miệt	m i ệ t |
vĩnh	v ĩ n h |
cham	c h a m |
nhài	n h à i |
tạp	t ạ p |
giéo	g i é o |
tbt	t b t |
đup	đ u p |
oánh	o á n h |
nhảnh	n h ả n h |
mắt	m ắ t |
cáu	c á u |
lờm	l ờ m |
strích	s t r í c h |
cữ	c ữ |
tỏm	t ỏ m |
cổi	c ổ i |
nhằng	n h ằ n g |
đangtriển	đ a n g t r i ể n |
tình	t ì n h |
phởn	p h ở n |
aptomat	a p t o m a t |
khích	k h í c h |
bớ	b ớ |
hởi	h ở i |
mững	m ữ n g |
nhẹp	n h ẹ p |
é	é |
sưởi	s ư ở i |
bẫng	b ẫ n g |
tội	t ộ i |
nhầm	n h ầ m |
chạng	c h ạ n g |
coóng	c o ó n g |
nhém	n h é m |
bồi	b ồ i |
tp	t p |
rét	r é t |
viển	v i ể n |
chúng	c h ú n g |
chói	c h ó i |
đã	đ ã |
glycerin	g l y c e r i n |
oxygen	o x y g e n |
chắm	c h ắ m |
pưh	p ư h |
catalunya	c a t a l u n y a |
khổ	k h ổ |
phôtô	p h ô t ô |
lị	l ị |
ùa	ù a |
gán	g á n |
sạ	s ạ |
èn	è n |
trackpoint	t r a c k p o i n t |
protein	p r o t e i n |
phướn	p h ư ớ n |
luya	l u y a |
lung	l u n g |
xinhan	x i n h a n |
ly	l y |
vưởng	v ư ở n g |
soạn	s o ạ n |
tuyn	t u y n |
trũi	t r ũ i |
thét	t h é t |
laser	l a s e r |
phiến	p h i ế n |
opset	o p s e t |
ống	ố n g |
vãnh	v ã n h |
độc	đ ộ c |
dồi	d ồ i |
vàm	v à m |
gồi	g ồ i |
mẽo	m ẽ o |
sín	s í n |
bươn	b ư ơ n |
găngxtơ	g ă n g x t ơ |
nguyện	n g u y ệ n |
huệ	h u ệ |
thuôn	t h u ô n |
ngã	n g ã |
vểnh	v ể n h |
duralumin	d u r a l u m i n |
xoét	x o é t |
nghềnh	n g h ề n h |
vâng	v â n g |
thẳng	t h ẳ n g |
thẹn	t h ẹ n |
ô	ô |
nảo	n ả o |
miêng	m i ê n g |
ụa	ụ a |
rày	r à y |
giuộc	g i u ộ c |
lải	l ả i |
ráng	r á n g |
vầng	v ầ n g |
chứa	c h ứ a |
zê	z ê |
tươi	t ư ơ i |
triệu	t r i ệ u |
rumba	r u m b a |
xía	x í a |
bề	b ề |
sợt	s ợ t |
carat	c a r a t |
xợp	x ợ p |
xiếc	x i ế c |
giồ	g i ồ |
maze	m a z e |
dăn	d ă n |
chấm	c h ấ m |
tiệp	t i ệ p |
giong	g i o n g |
tiệu	t i ệ u |
tróc	t r ó c |
nghểnh	n g h ể n h |
mãn	m ã n |
trumpet	t r u m p e t |
xoát	x o á t |
za	z a |
cồng	c ồ n g |
lâng	l â n g |
te	t e |
rấm	r ấ m |
huân	h u â n |
đắm	đ ắ m |
nòng	n ò n g |
p	p |
tỏe	t ỏ e |
thèo	t h è o |
chọp	c h ọ p |
fpt	f p t |
sếu	s ế u |
violon	v i o l o n |
tỉu	t ỉ u |
thố	t h ố |
plát	p l á t |
quẩy	q u ẩ y |
dổi	d ổ i |
cum	c u m |
tạ	t ạ |
quầy	q u ầ y |
nhóc	n h ó c |
xăngtimét	x ă n g t i m é t |
cha	c h a |
morat	m o r a t |
sos	s o s |
mò	m ò |
túa	t ú a |
tồn	t ồ n |
bướp	b ư ớ p |
tồ	t ồ |
không	k h ô n g |
bitum	b i t u m |
khặc	k h ặ c |
tre	t r e |
lắng	l ắ n g |
êcu	ê c u |
lảm	l ả m |
nghến	n g h ế n |
giết	g i ế t |
phúng	p h ú n g |
lỉu	l ỉ u |
doành	d o à n h |
gờ	g ờ |
phồ	p h ồ |
tụy	t ụ y |
nịt	n ị t |
lợm	l ợ m |
xăn	x ă n |
scanner	s c a n n e r |
pgs	p g s |
sãi	s ã i |
no	n o |
út	ú t |
giòn	g i ò n |
rậu	r ậ u |
quải	q u ả i |
nắc	n ắ c |
giữa	g i ữ a |
tẽn	t ẽ n |
hĩm	h ĩ m |
dói	d ó i |
huê	h u ê |
taekwondo	t a e k w o n d o |
he	h e |
forceps	f o r c e p s |
ouguiya	o u g u i y a |
mạch	m ạ c h |
kt	k t |
súp	s ú p |
bĩ	b ĩ |
xuềnh	x u ề n h |
ma	m a |
guilder	g u i l d e r |
khẹt	k h ẹ t |
quinacrine	q u i n a c r i n e |
mâm	m â m |
lộc	l ộ c |
bỉu	b ỉ u |
goong	g o o n g |
rẽ	r ẽ |
tháo	t h á o |
kuýp	k u ý p |
tría	t r í a |
ỷ	ỷ |
hiv	h i v |
nghếch	n g h ế c h |
day	d a y |
nòi	n ò i |
lèm	l è m |
quoàng	q u o à n g |
troi	t r o i |
choé	c h o é |
núm	n ú m |
dỏ	d ỏ |
trấn	t r ấ n |
tái	t á i |
ngoam	n g o a m |
khối	k h ố i |
nê	n ê |
mẻo	m ẻ o |
veo	v e o |
bếp	b ế p |
thờn	t h ờ n |
nan	n a n |
khung	k h u n g |
vái	v á i |
miên	m i ê n |
bch	b c h |
nhõ	n h õ |
cot	c o t |
stereo	s t e r e o |
ùm	ù m |
lởm	l ở m |
nhính	n h í n h |
khứng	k h ứ n g |
uytky	u y t k y |
cạ	c ạ |
sóoc	s ó o c |
điệm	đ i ệ m |
pít	p í t |
coọc	c o ọ c |
thõm	t h õ m |
đoạn	đ o ạ n |
nháu	n h á u |
rlâm	r l â m |
nhặng	n h ặ n g |
sìi	s ì i |
suyền	s u y ề n |
huênh	h u ê n h |
chen	c h e n |
prao	p r a o |
lội	l ộ i |
rọi	r ọ i |
trét	t r é t |
sóc	s ó c |
khì	k h ì |
độp	đ ộ p |
diệp	d i ệ p |
thồ	t h ồ |
họng	h ọ n g |
nhấy	n h ấ y |
pns	p n s |
phảy	p h ả y |
quế	q u ế |
riềm	r i ề m |
soàn	s o à n |
plastic	p l a s t i c |
sa	s a |
tenge	t e n g e |
che	c h e |
magi	m a g i |
dẩn	d ẩ n |
thầy	t h ầ y |
nhẵng	n h ẵ n g |
dấn	d ấ n |
báu	b á u |
kạn	k ạ n |
huờn	h u ờ n |
phùng	p h ù n g |
cố	c ố |
hớn	h ớ n |
nấm	n ấ m |
sàm	s à m |
nhùi	n h ù i |
studio	s t u d i o |
rươn	r ư ơ n |
miêu	m i ê u |
xua	x u a |
roàng	r o à n g |
sáo	s á o |
chãi	c h ã i |
cờn	c ờ n |
ngát	n g á t |
phế	p h ế |
hau	h a u |
mactensit	m a c t e n s i t |
ester	e s t e r |
ý	ý |
ngoài	n g o à i |
gạt	g ạ t |
địch	đ ị c h |
choáng	c h o á n g |
lỹ	l ỹ |
rùng	r ù n g |
lắt	l ắ t |
trật	t r ậ t |
gẫm	g ẫ m |
côtông	c ô t ô n g |
rỗ	r ỗ |
hua	h u a |
mể	m ể |
thoắt	t h o ắ t |
chùi	c h ù i |
mũm	m ũ m |
protid	p r o t i d |
quạng	q u ạ n g |
thủy	t h ủ y |
chuốt	c h u ố t |
strep	s t r e p |
mống	m ố n g |
gặm	g ặ m |
nhòn	n h ò n |
phớn	p h ớ n |
rọm	r ọ m |
hecto	h e c t o |
mezon	m e z o n |
biu	b i u |
rial	r i a l |
xường	x ư ờ n g |
mam	m a m |
kilo	k i l o |
xoả	x o ả |
mẩu	m ẩ u |
hd	h d |
nặc	n ặ c |
neutron	n e u t r o n |
carbur	c a r b u r |
rỏn	r ỏ n |
oài	o à i |
tung	t u n g |
guđron	g u đ r o n |
cởi	c ở i |
tàm	t à m |
niệu	n i ệ u |
khần	k h ầ n |
thước	t h ư ớ c |
sấm	s ấ m |
quấy	q u ấ y |
gổ	g ổ |
rộp	r ộ p |
khuyển	k h u y ể n |
nghiện	n g h i ệ n |
mộ	m ộ |
uỷ	u ỷ |
bạu	b ạ u |
khỉ	k h ỉ |
banjo	b a n j o |
casset	c a s s e t |
bitcôt	b i t c ô t |
lỏn	l ỏ n |
thong	t h o n g |
ngâm	n g â m |
kiền	k i ề n |
liệt	l i ệ t |
khuấy	k h u ấ y |
nh	n h |
mạo	m ạ o |
rữ	r ữ |
soán	s o á n |
ra	r a |
nhụy	n h ụ y |
lộm	l ộ m |
bướng	b ư ớ n g |
lâu	l â u |
ven	v e n |
kịch	k ị c h |
mói	m ó i |
vục	v ụ c |
peritxoa	p e r i t x o a |
thũng	t h ũ n g |
cán	c á n |
lắm	l ắ m |
photocopi	p h o t o c o p i |
xượi	x ư ợ i |
tòra	t ò r a |
vonfram	v o n f r a m |
tiết	t i ế t |
dư	d ư |
bs	b s |
ộp	ộ p |
tb	t b |
buổi	b u ổ i |
chậu	c h ậ u |
nhòe	n h ò e |
gip	g i p |
bidv	b i d v |
quạt	q u ạ t |
bỗm	b ỗ m |
tắn	t ắ n |
uôm	u ô m |
khom	k h o m |
ngoẳn	n g o ẳ n |
gam	g a m |
phèng	p h è n g |
xụt	x ụ t |
vở	v ở |
trếch	t r ế c h |
lốp	l ố p |
hine	h i n e |
bệ	b ệ |
bới	b ớ i |
vẹn	v ẹ n |
nhoam	n h o a m |
méc	m é c |
tời	t ờ i |
password	p a s s w o r d |
serenata	s e r e n a t a |
chùn	c h ù n |
ệ	ệ |
ló	l ó |
trước	t r ư ớ c |
cuông	c u ô n g |
thiêng	t h i ê n g |
nhẫn	n h ẫ n |
cử	c ử |
lẩn	l ẩ n |
mùa	m ù a |
marketing	m a r k e t i n g |
caosu	c a o s u |
giám	g i á m |
inch	i n c h |
fruit	f r u i t |
abel	a b e l |
đảng	đ ả n g |
telex	t e l e x |
tang	t a n g |
vẩu	v ẩ u |
cảu	c ả u |
ấn	ấ n |
đảnh	đ ả n h |
vạ	v ạ |
đoạt	đ o ạ t |
kiết	k i ế t |
bịa	b ị a |
khòng	k h ò n g |
nghểu	n g h ể u |
lờ	l ờ |
thà	t h à |
cmt	c m t |
pang	p a n g |
lèõ	l è õ |
trắng	t r ắ n g |
giói	g i ó i |
tuyết	t u y ế t |
khao	k h a o |
tét	t é t |
lợn	l ợ n |
chê	c h ê |
sanh	s a n h |
gụ	g ụ |
đùa	đ ù a |
thoà	t h o à |
giao	g i a o |
trưng	t r ư n g |
dài	d à i |
sồng	s ồ n g |
magnetite	m a g n e t i t e |
kon	k o n |
tròi	t r ò i |
bầm	b ầ m |
bunke	b u n k e |
rọc	r ọ c |
doá	d o á |
dệch	d ệ c h |
déo	d é o |
ghê	g h ê |
văn	v ă n |
đáy	đ á y |
chẹ	c h ẹ |
sót	s ó t |
sạch	s ạ c h |
thoái	t h o á i |
toóc	t o ó c |
đẵn	đ ẵ n |
xtrép	x t r é p |
popeline	p o p e l i n e |
rộc	r ộ c |
ngác	n g á c |
loảng	l o ả n g |
hập	h ậ p |
còi	c ò i |
lôi	l ô i |
nhầy	n h ầ y |
ròm	r ò m |
ẽo	ẽ o |
spe	s p e |
visa	v i s a |
martin	m a r t i n |
thuê	t h u ê |
taiga	t a i g a |
nhuôm	n h u ô m |
rấn	r ấ n |
tôn	t ô n |
mụi	m ụ i |
vỉ	v ỉ |
kalium	k a l i u m |
giấc	g i ấ c |
xô	x ô |
chắp	c h ắ p |
phần	p h ầ n |
dốp	d ố p |
nhặm	n h ặ m |
sáp	s á p |
nồ	n ồ |
rớm	r ớ m |
thuyên	t h u y ê n |
bầu	b ầ u |
bằn	b ằ n |
huy	h u y |
mạp	m ạ p |
hiđroxit	h i đ r o x i t |
ngưa	n g ư a |
dicdăc	d i c d ă c |
đua	đ u a |
acid	a c i d |
vay	v a y |
xo	x o |
phun	p h u n |
xuyến	x u y ế n |
ptcs	p t c s |
rừng	r ừ n g |
chườm	c h ư ờ m |
dệt	d ệ t |
festival	f e s t i v a l |
sễ	s ễ |
dùm	d ù m |
dặc	d ặ c |
nina	n i n a |
nghiêm	n g h i ê m |
dê	d ê |
úm	ú m |
hãi	h ã i |
qđttg	q đ t t g |
zô	z ô |
chợn	c h ợ n |
gianh	g i a n h |
duôi	d u ô i |
khờ	k h ờ |
bam	b a m |
naphthalen	n a p h t h a l e n |
hop	h o p |
pm	p m |
vin	v i n |
mậy	m ậ y |
cif	c i f |
nhải	n h ả i |
àdạ	à d ạ |
bgđ	b g đ |
háu	h á u |
morse	m o r s e |
trất	t r ấ t |
trán	t r á n |
gắp	g ắ p |
khấm	k h ấ m |
ệnh	ệ n h |
đuối	đ u ố i |
ngớt	n g ớ t |
ngưỡng	n g ư ỡ n g |
trồng	t r ồ n g |
đũng	đ ũ n g |
chxhcn	c h x h c n |
loay	l o a y |
xentimét	x e n t i m é t |
vối	v ố i |
lót	l ó t |
xớ	x ớ |
nậm	n ậ m |
bặt	b ặ t |
giam	g i a m |
baỏ	b a ỏ |
rôi	r ô i |
thao	t h a o |
hưu	h ư u |
lùng	l ù n g |
ngáy	n g á y |
óng	ó n g |
nghêu	n g h ê u |
bủn	b ủ n |
quạnh	q u ạ n h |
tọc	t ọ c |
rẹc	r ẹ c |
nhào	n h à o |
quọ	q u ọ |
nến	n ế n |
â	â |
manganese	m a n g a n e s e |
dường	d ư ờ n g |
vớt	v ớ t |
gạy	g ạ y |
cúp	c ú p |
ôplêt	ô p l ê t |
phiu	p h i u |
phóc	p h ó c |
mọn	m ọ n |
pb	p b |
lavabo	l a v a b o |
chiết	c h i ế t |
rao	r a o |
huyệt	h u y ệ t |
đọi	đ ọ i |
dệnh	d ệ n h |
xớm	x ớ m |
s	s |
chui	c h u i |
giọt	g i ọ t |
xẻo	x ẻ o |
nhốp	n h ố p |
nhuốm	n h u ố m |
lẹ	l ẹ |
fa	f a |
hoài	h o à i |
hoành	h o à n h |
tườu	t ư ờ u |
ễnh	ễ n h |
gen	g e n |
amen	a m e n |
đuềnh	đ u ề n h |
pích	p í c h |
đề	đ ề |
chờm	c h ờ m |
rón	r ó n |
tóp	t ó p |
ring	r i n g |
thịch	t h ị c h |
sán	s á n |
xinê	x i n ê |
bét	b é t |
giủi	g i ủ i |
thự	t h ự |
thẻn	t h ẻ n |
vazơlin	v a z ơ l i n |
zêrô	z ê r ô |
đừ	đ ừ |
gps	g p s |
lỏa	l ỏ a |
vờn	v ờ n |
xước	x ư ớ c |
nia	n i a |
sáy	s á y |
hz	h z |
cạn	c ạ n |
burst	b u r s t |
tủy	t ủ y |
đríc	đ r í c |
tắp	t ắ p |
nhàng	n h à n g |
lằn	l ằ n |
toẽ	t o ẽ |
sĩ	s ĩ |
chá	c h á |
hờn	h ờ n |
sớ	s ớ |
quắc	q u ắ c |
bải	b ả i |
nể	n ể |
đức	đ ứ c |
roá	r o á |
ngạnh	n g ạ n h |
bượt	b ư ợ t |
nộng	n ộ n g |
nhúa	n h ú a |
xàm	x à m |
nộm	n ộ m |
biếng	b i ế n g |
chào	c h à o |
điên	đ i ê n |
nhấp	n h ấ p |
thặng	t h ặ n g |
chục	c h ụ c |
khạch	k h ạ c h |
đễnh	đ ễ n h |
lác	l á c |
ch	c h |
gialai	g i a l a i |
chối	c h ố i |
phé	p h é |
ghẹ	g h ẹ |
lin	l i n |
khịt	k h ị t |
culong	c u l o n g |
giấp	g i ấ p |
xệu	x ệ u |
cosine	c o s i n e |
liveshow	l i v e s h o w |
xiêm	x i ê m |
trư	t r ư |
khòe	k h ò e |
tra	t r a |
gứng	g ứ n g |
ghen	g h e n |
gầu	g ầ u |
đôm	đ ô m |
mào	m à o |
wales	w a l e s |
cưa	c ư a |
bỏi	b ỏ i |
sồi	s ồ i |
trớ	t r ớ |
ngỗ	n g ỗ |
mủn	m ủ n |
cằm	c ằ m |
lỗ	l ỗ |
nhạc	n h ạ c |
cạch	c ạ c h |
lướu	l ư ớ u |
ăcquy	ă c q u y |
khau	k h a u |
séc	s é c |
kháng	k h á n g |
vỏ	v ỏ |
kwh	k w h |
rồn	r ồ n |
cảng	c ả n g |
thía	t h í a |
mi	m i |
chip	c h i p |
bều	b ề u |
xạu	x ạ u |
ngam	n g a m |
đêh	đ ê h |
phực	p h ự c |
giặn	g i ặ n |
nghịt	n g h ị t |
náng	n á n g |
to	t o |
luỵ	l u ỵ |
phiếu	p h i ế u |
dải	d ả i |
lãnh	l ã n h |
lừ	l ừ |
vả	v ả |
vưc	v ư c |
muồng	m u ồ n g |
ghệ	g h ệ |
ghi	g h i |
phàng	p h à n g |
đò	đ ò |
oóc	o ó c |
ninh	n i n h |
quán	q u á n |
roòng	r o ò n g |
tề	t ề |
tập	t ậ p |
tứa	t ứ a |
xành	x à n h |
ben	b e n |
điop	đ i o p |
vrê	v r ê |
video	v i d e o |
niutơn	n i u t ơ n |
mêga	m ê g a |
nược	n ư ợ c |
vò	v ò |
nguyễnthị	n g u y ễ n t h ị |
ngứ	n g ứ |
buộc	b u ộ c |
seoul	s e o u l |
muỗm	m u ỗ m |
fon	f o n |
ua	u a |
rờn	r ờ n |
yểm	y ể m |
dực	d ự c |
vấp	v ấ p |
gìn	g ì n |
nhỉu	n h ỉ u |
phôn	p h ô n |
lận	l ậ n |
ân	â n |
dỡ	d ỡ |
nhôi	n h ô i |
cốm	c ố m |
vọ	v ọ |
dè	d è |
bòm	b ò m |
xóc	x ó c |
vọc	v ọ c |
rọn	r ọ n |
sịch	s ị c h |
xibecnetic	x i b e c n e t i c |
trẻo	t r ẻ o |
blu	b l u |
xụ	x ụ |
licence	l i c e n c e |
nghiễm	n g h i ễ m |
khôn	k h ô n |
măk	m ă k |
quại	q u ạ i |
hữu	h ữ u |
amatơ	a m a t ơ |
dím	d í m |
féc	f é c |
ươi	ư ơ i |
vượng	v ư ợ n g |
vủn	v ủ n |
thẩu	t h ẩ u |
thiết	t h i ế t |
vắng	v ắ n g |
cự	c ự |
sắác	s ắ á c |
khóm	k h ó m |
kẻm	k ẻ m |
thiệu	t h i ệ u |
líc	l í c |
ọi	ọ i |
thăm	t h ă m |
luồn	l u ồ n |
rận	r ậ n |
xông	x ô n g |
colophan	c o l o p h a n |
điệ	đ i ệ |
sacarin	s a c a r i n |
khẳm	k h ẳ m |
polyethylen	p o l y e t h y l e n |
thoa	t h o a |
choét	c h o é t |
phao	p h a o |
rửa	r ử a |
thều	t h ề u |
đởm	đ ở m |
khyển	k h y ể n |
nhiếp	n h i ế p |
mươi	m ư ơ i |
đô	đ ô |
mít	m í t |
confetti	c o n f e t t i |
soà	s o à |
ngoặt	n g o ặ t |
coca	c o c a |
giề	g i ề |
tăm	t ă m |
cron	c r o n |
dớ	d ớ |
nắn	n ắ n |
quao	q u a o |
tam	t a m |
rợ	r ợ |
vâ	v â |
tạithôn	t ạ i t h ô n |
tcn	t c n |
tong	t o n g |
nhỉ	n h ỉ |
trớn	t r ớ n |
gảnh	g ả n h |
giỡn	g i ỡ n |
woat	w o a t |
vuốt	v u ố t |
ục	ụ c |
khẳng	k h ẳ n g |
lầu	l ầ u |
nhễ	n h ễ |
tương	t ư ơ n g |
bõm	b õ m |
đít	đ í t |
thùm	t h ù m |
organ	o r g a n |
bột	b ộ t |
thồi	t h ồ i |
định	đ ị n h |
cưu	c ư u |
chạnh	c h ạ n h |
thít	t h í t |
muông	m u ô n g |
quơ	q u ơ |
lố	l ố |
gệt	g ệ t |
him	h i m |
batoong	b a t o o n g |
khướu	k h ư ớ u |
bước	b ư ớ c |
palăng	p a l ă n g |
buồi	b u ồ i |
bru	b r u |
bẩu	b ẩ u |
ti	t i |
vạy	v ạ y |
sẫm	s ẫ m |
đống	đ ố n g |
dún	d ú n |
bay	b a y |
nhuyễn	n h u y ễ n |
trụa	t r ụ a |
hào	h à o |
hoẻn	h o ẻ n |
trùn	t r ù n |
triền	t r i ề n |
xuya	x u y a |
hùn	h ù n |
quát	q u á t |
mọng	m ọ n g |
thỏm	t h ỏ m |
khuắng	k h u ắ n g |
thủng	t h ủ n g |
xuổng	x u ổ n g |
ete	e t e |
tỉa	t ỉ a |
gưởi	g ư ở i |
tdtt	t d t t |
khị	k h ị |
ngoã	n g o ã |
gon	g o n |
nguyệt	n g u y ệ t |
hão	h ã o |
von	v o n |
container	c o n t a i n e r |
hematite	h e m a t i t e |
vỵ	v ỵ |
crếp	c r ế p |
tươì	t ư ơ ì |
zắc	z ắ c |
gội	g ộ i |
magazin	m a g a z i n |
bép	b é p |
ớn	ớ n |
trịch	t r ị c h |
chuệch	c h u ệ c h |
chỗm	c h ỗ m |
sính	s í n h |
pts	p t s |
vèo	v è o |
vì	v ì |
nhưỡng	n h ư ỡ n g |
bẽo	b ẽ o |
ngoảm	n g o ả m |
inox	i n o x |
tuyển	t u y ể n |
labo	l a b o |
khót	k h ó t |
nhẳn	n h ẳ n |
rộn	r ộ n |
sải	s ả i |
mả	m ả |
dằng	d ằ n g |
chang	c h a n g |
iu	i u |
ngùng	n g ù n g |
run	r u n |
suy	s u y |
yên	y ê n |
vòn	v ò n |
káp	k á p |
hẩng	h ẩ n g |
antipyrin	a n t i p y r i n |
hùng	h ù n g |
dận	d ậ n |
cẩm	c ẩ m |
nghuê	n g h u ê |
trẽn	t r ẽ n |
chỉn	c h ỉ n |
ngấp	n g ấ p |
ăccoócđêông	ă c c o ó c đ ê ô n g |
rơn	r ơ n |
thơn	t h ơ n |
khuỳnh	k h u ỳ n h |
khóc	k h ó c |
boạt	b o ạ t |
mận	m ậ n |
dịch	d ị c h |
thù	t h ù |
ơm	ơ m |
ngùn	n g ù n |
rải	r ả i |
nhẩm	n h ẩ m |
ét	é t |
bã	b ã |
calo	c a l o |
hóa	h ó a |
ephedrine	e p h e d r i n e |
thuỗn	t h u ỗ n |
hề	h ề |
khấp	k h ấ p |
véc	v é c |
lao	l a o |
vọp	v ọ p |
rem	r e m |
đồ	đ ồ |
ốc	ố c |
choắt	c h o ắ t |
crin	c r i n |
khuê	k h u ê |
kde	k d e |
nạy	n ạ y |
chên	c h ê n |
kyat	k y a t |
phóng	p h ó n g |
lá	l á |
sỡ	s ỡ |
trĩnh	t r ĩ n h |
then	t h e n |
cói	c ó i |
ngáu	n g á u |
trở	t r ở |
bo	b o |
thành	t h à n h |
biếu	b i ế u |
nùng	n ù n g |
ngòn	n g ò n |
bàm	b à m |
chẩm	c h ẩ m |
đìa	đ ì a |
atlas	a t l a s |
đợp	đ ợ p |
ngạo	n g ạ o |
giác	g i á c |
cathode	c a t h o d e |
vô	v ô |
sóp	s ó p |
vãng	v ã n g |
quờn	q u ờ n |
quét	q u é t |
vaselin	v a s e l i n |
leng	l e n g |
bâu	b â u |
trát	t r á t |
quảy	q u ả y |
quặn	q u ặ n |
bương	b ư ơ n g |
ngành	n g à n h |
hồng	h ồ n g |
kham	k h a m |
mửng	m ử n g |
gớm	g ớ m |
nguy	n g u y |
đỉa	đ ỉ a |
tượp	t ư ợ p |
đơn	đ ơ n |
lẹn	l ẹ n |
diếp	d i ế p |
chểnh	c h ể n h |
cư	c ư |
rơm	r ơ m |
mão	m ã o |
phêu	p h ê u |
bhxh	b h x h |
ông	ô n g |
quỷnh	q u ỷ n h |
xảo	x ả o |
chu	c h u |
thực	t h ự c |
cologarit	c o l o g a r i t |
tức	t ứ c |
hẻo	h ẻ o |
diệu	d i ệ u |
kmun	k m u n |
ráy	r á y |
quáu	q u á u |
cạm	c ạ m |
cứng	c ứ n g |
sậy	s ậ y |
ná	n á |
hơ	h ơ |
vương	v ư ơ n g |
bupbê	b u p b ê |
phịa	p h ị a |
mỗ	m ỗ |
tđd	t đ d |
milimét	m i l i m é t |
loăng	l o ă n g |
hụm	h ụ m |
nhín	n h í n |
liếu	l i ế u |
hoàn	h o à n |
hoẳn	h o ẳ n |
hẻn	h ẻ n |
reo	r e o |
xất	x ấ t |
chim	c h i m |
nhèm	n h è m |
tờ	t ờ |
photocopy	p h o t o c o p y |
sôvanh	s ô v a n h |
sms	s m s |
bấn	b ấ n |
dọc	d ọ c |
xứ	x ứ |
hỏ	h ỏ |
nicotin	n i c o t i n |
vên	v ê n |
cằn	c ằ n |
cản	c ả n |
gió	g i ó |
múm	m ú m |
kép	k é p |
dụ	d ụ |
khòn	k h ò n |
nhằn	n h ằ n |
cung	c u n g |
hỡm	h ỡ m |
krêy	k r ê y |
atmosphe	a t m o s p h e |
vỏng	v ỏ n g |
drachma	d r a c h m a |
nối	n ố i |
boong	b o o n g |
suôn	s u ô n |
hđmbđ	h đ m b đ |
tôm	t ô m |
ngớ	n g ớ |
windows	w i n d o w s |
khùa	k h ù a |
chxhcnvn	c h x h c n v n |
dĩn	d ĩ n |
xoài	x o à i |
xếp	x ế p |
sầm	s ầ m |
chuồn	c h u ồ n |
nịch	n ị c h |
với	v ớ i |
bằng	b ằ n g |
chẻng	c h ẻ n g |
dóng	d ó n g |
buýt	b u ý t |
trừa	t r ừ a |
n	n |
sẻn	s ẻ n |
lau	l a u |
sởn	s ở n |
giậm	g i ậ m |
câu	c â u |
xạc	x ạ c |
naphthalene	n a p h t h a l e n e |
teo	t e o |
bèo	b è o |
rực	r ự c |
trếu	t r ế u |
canô	c a n ô |
phật	p h ậ t |
tréo	t r é o |
rỉ	r ỉ |
c	c |
khừng	k h ừ n g |
sộp	s ộ p |
pirit	p i r i t |
quí	q u í |
lọi	l ọ i |
lum	l u m |
bũm	b ũ m |
toạ	t o ạ |
pyrit	p y r i t |
tòi	t ò i |
thân	t h â n |
gioàng	g i o à n g |
kuna	k u n a |
khân	k h â n |
phướng	p h ư ớ n g |
phẫn	p h ẫ n |
vân	v â n |
khắt	k h ắ t |
psi	p s i |
tuôcbin	t u ô c b i n |
kít	k í t |
cọt	c ọ t |
cò	c ò |
nóng	n ó n g |
ga	g a |
khoái	k h o á i |
rum	r u m |
cẳón	c ẳ ó n |
dày	d à y |
đàm	đ à m |
khách	k h á c h |
cuôr	c u ô r |
sâmbanh	s â m b a n h |
rớp	r ớ p |
thiến	t h i ế n |
tuýp	t u ý p |
chồi	c h ồ i |
cần	c ầ n |
robotic	r o b o t i c |
già	g i à |
ngoắt	n g o ắ t |
metan	m e t a n |
vòm	v ò m |
nhạng	n h ạ n g |
nguây	n g u â y |
tèng	t è n g |
tham	t h a m |
mẫn	m ẫ n |
xoàm	x o à m |
xtốp	x t ố p |
khoẻ	k h o ẻ |
nhóp	n h ó p |
gồng	g ồ n g |
goục	g o ụ c |
tà	t à |
này	n à y |
cửng	c ử n g |
bar	b a r |
manip	m a n i p |
hì	h ì |
lithium	l i t h i u m |
cựa	c ự a |
êđê	ê đ ê |
nhổ	n h ổ |
tanh	t a n h |
hđ	h đ |
bả	b ả |
hếu	h ế u |
lịa	l ị a |
hủn	h ủ n |
ziczac	z i c z a c |
phung	p h u n g |
tục	t ụ c |
mó	m ó |
ja	j a |
gric	g r i c |
fluorur	f l u o r u r |
khẻ	k h ẻ |
patinê	p a t i n ê |
nhai	n h a i |
trành	t r à n h |
chuôi	c h u ô i |
riel	r i e l |
sượt	s ư ợ t |
thúy	t h ú y |
gigabyte	g i g a b y t e |
thiếc	t h i ế c |
ríp	r í p |
trời	t r ờ i |
rủi	r ủ i |
xẻng	x ẻ n g |
mè	m è |
ko	k o |
gác	g á c |
dông	d ô n g |
mammuth	m a m m u t h |
phôi	p h ô i |
dua	d u a |
tuần	t u ầ n |
carbonic	c a r b o n i c |
yêm	y ê m |
đấy	đ ấ y |
tim	t i m |
dẫm	d ẫ m |
xốt	x ố t |
trịnh	t r ị n h |
theo	t h e o |
trẹ	t r ẹ |
prong	p r o n g |
tột	t ộ t |
trằm	t r ằ m |
môđéc	m ô đ é c |
tiệm	t i ệ m |
dhị	d h ị |
băm	b ă m |
balô	b a l ô |
gene	g e n e |
múc	m ú c |
voa	v o a |
nhắnmà	n h ắ n m à |
tên	t ê n |
ngây	n g â y |
lừa	l ừ a |
ngạn	n g ạ n |
rứa	r ứ a |
sáu	s á u |
gút	g ú t |
kẹ	k ẹ |
thẫm	t h ẫ m |
ngỗi	n g ỗ i |
đa	đ a |
chẻm	c h ẻ m |
của	c ủ a |
gờm	g ờ m |
cổ	c ổ |
xở	x ở |
cnxh	c n x h |
sạo	s ạ o |
trượng	t r ư ợ n g |
dựng	d ự n g |
hỏm	h ỏ m |
choạc	c h o ạ c |
bạm	b ạ m |
nứ	n ứ |
nghị	n g h ị |
shop	s h o p |
cỏm	c ỏ m |
tranh	t r a n h |
vấy	v ấ y |
hipebol	h i p e b o l |
xăm	x ă m |
nhó	n h ó |
bó	b ó |
vịn	v ị n |
tuavit	t u a v i t |
heng	h e n g |
chệm	c h ệ m |
sulfuric	s u l f u r i c |
pà	p à |
culit	c u l i t |
tả	t ả |
nháp	n h á p |
noong	n o o n g |
vạnh	v ạ n h |
hảo	h ả o |
nghen	n g h e n |
chịn	c h ị n |
ghẹn	g h ẹ n |
nường	n ư ờ n g |
nghẽn	n g h ẽ n |
liếng	l i ế n g |
nhát	n h á t |
lưởng	l ư ở n g |
thêu	t h ê u |
ghita	g h i t a |
ngồm	n g ồ m |
chj	c h j |
sưng	s ư n g |
ngợm	n g ợ m |
háy	h á y |
chừa	c h ừ a |
ghiếc	g h i ế c |
ngoác	n g o á c |
cứ	c ứ |
tu	t u |
chặc	c h ặ c |
kế	k ế |
flo	f l o |
xốn	x ố n |
tớn	t ớ n |
xẹp	x ẹ p |
phoóc	p h o ó c |
xổn	x ổ n |
miu	m i u |
muôi	m u ô i |
thế	t h ế |
mnhời	m n h ờ i |
nẻo	n ẻ o |
fly	f l y |
gắng	g ắ n g |
gg	g g |
nhòng	n h ò n g |
pay	p a y |
nép	n é p |
ngoan	n g o a n |
vằn	v ằ n |
bẻo	b ẻ o |
hốt	h ố t |
nhía	n h í a |
coulomb	c o u l o m b |
ri	r i |
iý	i ý |
bưu	b ư u |
tịt	t ị t |
nhúng	n h ú n g |
ọp	ọ p |
nứng	n ứ n g |
cớt	c ớ t |
chứng	c h ứ n g |
chếp	c h ế p |
karate	k a r a t e |
thàm	t h à m |
ơi	ơ i |
fát	f á t |
mâp	m â p |
chới	c h ớ i |
so	s o |
nhèn	n h è n |
cáo	c á o |
đoác	đ o á c |
vính	v í n h |
hăng	h ă n g |
dùa	d ù a |
đạp	đ ạ p |
thay	t h a y |
nhác	n h á c |
vũ	v ũ |
ò	ò |
vượt	v ư ợ t |
hửng	h ử n g |
gơn	g ơ n |
gión	g i ó n |
lặm	l ặ m |
quart	q u a r t |
kốc	k ố c |
kĩu	k ĩ u |
khắn	k h ắ n |
tráng	t r á n g |
búc	b ú c |
nhão	n h ã o |
miện	m i ệ n |
tòa	t ò a |
ắc	ắ c |
ổi	ổ i |
hum	h u m |
bẵm	b ẵ m |
báng	b á n g |
ẩu	ẩ u |
trù	t r ù |
tộ	t ộ |
tit	t i t |
truân	t r u â n |
xinh	x i n h |
đểm	đ ể m |
boi	b o i |
ơristic	ơ r i s t i c |
pai	p a i |
tý	t ý |
khôi	k h ô i |
nhoáy	n h o á y |
liêng	l i ê n g |
gậy	g ậ y |
virus	v i r u s |
ngoáy	n g o á y |
lãm	l ã m |
mớm	m ớ m |
nầm	n ầ m |
địu	đ ị u |
ngạc	n g ạ c |
mỗi	m ỗ i |
sốp	s ố p |
thớ	t h ớ |
chấy	c h ấ y |
bí	b í |
xabôchê	x a b ô c h ê |
quặp	q u ặ p |
nhủi	n h ủ i |
vức	v ứ c |
cưỡì	c ư ỡ ì |
mứt	m ứ t |
riên	r i ê n |
nhỏng	n h ỏ n g |
đỏ	đ ỏ |
cli	c l i |
mớmớ	m ớ m ớ |
thăng	t h ă n g |
nề	n ề |
nhiện	n h i ệ n |
dớp	d ớ p |
léng	l é n g |
giạ	g i ạ |
z	z |
pull	p u l l |
mao	m a o |
nghé	n g h é |
decibel	d e c i b e l |
loãng	l o ã n g |
kiôt	k i ô t |
xách	x á c h |
nhìn	n h ì n |
florua	f l o r u a |
nicotine	n i c o t i n e |
tcyttg	t c y t t g |
sạt	s ạ t |
vố	v ố |
đúc	đ ú c |
tuỵ	t u ỵ |
kiêm	k i ê m |
hơm	h ơ m |
hóm	h ó m |
nhộm	n h ộ m |
chèn	c h è n |
gli	g l i |
macô	m a c ô |
chong	c h o n g |
tép	t é p |
rôma	r ô m a |
bậc	b ậ c |
kình	k ì n h |
đốm	đ ố m |
côi	c ô i |
nq	n q |
pụa	p ụ a |
ngừ	n g ừ |
rếp	r ế p |
róc	r ó c |
sết	s ế t |
xém	x é m |
giớ	g i ớ |
piêu	p i ê u |
puy	p u y |
ngân	n g â n |
mdhur	m d h u r |
proverb	p r o v e r b |
la	l a |
dồng	d ồ n g |
vông	v ô n g |
nhoàng	n h o à n g |
gây	g â y |
hông	h ô n g |
hiểu	h i ể u |
nguôn	n g u ô n |
doan	d o a n |
vạc	v ạ c |
ag	a g |
micron	m i c r o n |
olympic	o l y m p i c |
họa	h ọ a |
sộc	s ộ c |
nang	n a n g |
cương	c ư ơ n g |
nói	n ó i |
chão	c h ã o |
chuyến	c h u y ế n |
em	e m |
giâm	g i â m |
miểng	m i ể n g |
vựa	v ự a |
quởn	q u ở n |
thủ	t h ủ |
ờm	ờ m |
diềng	d i ề n g |
ậu	ậ u |
liệng	l i ệ n g |
lenition	l e n i t i o n |
nóp	n ó p |
xược	x ư ợ c |
sét	s é t |
hoang	h o a n g |
dụp	d ụ p |
dàn	d à n |
hộc	h ộ c |
cocain	c o c a i n |
algorithm	a l g o r i t h m |
khởi	k h ở i |
hũ	h ũ |
xun	x u n |
cỏi	c ỏ i |
đe	đ e |
khảch	k h ả c h |
quết	q u ế t |
nhút	n h ú t |
fara	f a r a |
nhuế	n h u ế |
cb	c b |
cẫn	c ẫ n |
thưọng	t h ư ọ n g |
khằn	k h ằ n |
nhét	n h é t |
thách	t h á c h |
bíp	b í p |
phở	p h ở |
xớn	x ớ n |
phờ	p h ờ |
quành	q u à n h |
artel	a r t e l |
phối	p h ố i |
thuộm	t h u ộ m |
háp	h á p |
nhớ	n h ớ |
chởm	c h ở m |
mược	m ư ợ c |
vồi	v ồ i |
gĩữ	g ĩ ữ |
cây	c â y |
xcô	x c ô |
bẩm	b ẩ m |
nhiều	n h i ề u |
đexiben	đ e x i b e n |
pen	p e n |
giằn	g i ằ n |
húng	h ú n g |
angorit	a n g o r i t |
búp	b ú p |
cớm	c ớ m |
hạp	h ạ p |
rẹt	r ẹ t |
ào	à o |
nhắp	n h ắ p |
ximpozium	x i m p o z i u m |
kiểng	k i ể n g |
núi	n ú i |
choah	c h o a h |
alumin	a l u m i n |
chrom	c h r o m |
đay	đ a y |
hiềm	h i ề m |
bộ	b ộ |
réo	r é o |
nâm	n â m |
nhéo	n h é o |
thảo	t h ả o |
intranet	i n t r a n e t |
dàu	d à u |
chlorur	c h l o r u r |
hĩnh	h ĩ n h |
sexy	s e x y |
alpha	a l p h a |
quai	q u a i |
phosphor	p h o s p h o r |
bửng	b ử n g |
nhiễn	n h i ễ n |
mèềm	m è ề m |
sún	s ú n |
típ	t í p |
khin	k h i n |
tịn	t ị n |
gangster	g a n g s t e r |
meo	m e o |
gióng	g i ó n g |
pla	p l a |
phạc	p h ạ c |
trưởnc	t r ư ở n c |
radar	r a d a r |
sưót	s ư ó t |
trùy	t r ù y |
nắp	n ắ p |
loòng	l o ò n g |
huỵch	h u ỵ c h |
truy	t r u y |
lương	l ư ơ n g |
dởm	d ở m |
thướt	t h ư ớ t |
hỷ	h ỷ |
giương	g i ư ơ n g |
phọc	p h ọ c |
rảu	r ả u |
cở	c ở |
hui	h u i |
huơ	h u ơ |
trữ	t r ữ |
rãnh	r ã n h |
chèo	c h è o |
ghèn	g h è n |
môbilet	m ô b i l e t |
kìm	k ì m |
gõ	g õ |
culông	c u l ô n g |
hòe	h ò e |
núng	n ú n g |
ngôn	n g ô n |
glăng	g l ă n g |
ngóp	n g ó p |
oại	o ạ i |
lé	l é |
sềnh	s ề n h |
duyên	d u y ê n |
tòrô	t ò r ô |
micrô	m i c r ô |
đâm	đ â m |
mát	m á t |
camnhông	c a m n h ô n g |
sống	s ố n g |
phlắc	p h l ắ c |
nhội	n h ộ i |
ôi	ô i |
chủm	c h ủ m |
mũ	m ũ |
đắng	đ ắ n g |
lito	l i t o |
viếng	v i ế n g |
nhoạm	n h o ạ m |
chdc	c h d c |
hừng	h ừ n g |
cót	c ó t |
bin	b i n |
cen	c e n |
toà	t o à |
ngoạm	n g o ạ m |
tâm	t â m |
xộc	x ộ c |
lông	l ô n g |
malthus	m a l t h u s |
algol	a l g o l |
mini	m i n i |
aceton	a c e t o n |
cơi	c ơ i |
liện	l i ệ n |
pát	p á t |
acquy	a c q u y |
kenvin	k e n v i n |
rêu	r ê u |
len	l e n |
rỵn	r ỵ n |
nhị	n h ị |
tó	t ó |
điện	đ i ệ n |
lọm	l ọ m |
dương	d ư ơ n g |
luýnh	l u ý n h |
nọc	n ọ c |
trẩm	t r ẩ m |
corpus	c o r p u s |
nge	n g e |
vung	v u n g |
olimpic	o l i m p i c |
đọt	đ ọ t |
lúm	l ú m |
thủa	t h ủ a |
nhảm	n h ả m |
phẩn	p h ẩ n |
mong	m o n g |
ngoảy	n g o ả y |
khựa	k h ự a |
epsilon	e p s i l o n |
mãi	m ã i |
thơm	t h ơ m |
khụ	k h ụ |
yd	y d |
ngào	n g à o |
phổ	p h ổ |
latin	l a t i n |
rung	r u n g |
spa	s p a |
đướng	đ ư ớ n g |
đrông	đ r ô n g |
ngấu	n g ấ u |
gom	g o m |
chi	c h i |
mối	m ố i |
bá	b á |
ráu	r á u |
tởm	t ở m |
cữu	c ữ u |
xũ	x ũ |
rợp	r ợ p |
óp	ó p |
ngụm	n g ụ m |
sổng	s ổ n g |
thím	t h í m |
xan	x a n |
sửu	s ử u |
base	b a s e |
trú	t r ú |
mét	m é t |
hơn	h ơ n |
giỗi	g i ỗ i |
phọng	p h ọ n g |
ngoẩy	n g o ẩ y |
ưỡn	ư ỡ n |
đềnh	đ ề n h |
hòn	h ò n |
xoăn	x o ă n |
rệp	r ệ p |
nghỉm	n g h ỉ m |
đâng	đ â n g |
quật	q u ậ t |
antimon	a n t i m o n |
ạch	ạ c h |
đung	đ u n g |
loàn	l o à n |
muốt	m u ố t |
quẩn	q u ẩ n |
trõm	t r õ m |
lacooc	l a c o o c |
phệ	p h ệ |
giấu	g i ấ u |
trộ	t r ộ |
gắm	g ắ m |
gột	g ộ t |
xủ	x ủ |
một	m ộ t |
lìa	l ì a |
chuếnh	c h u ế n h |
đ	đ |
kìn	k ì n |
lòi	l ò i |
thoăn	t h o ă n |
trăm	t r ă m |
thom	t h o m |
vập	v ậ p |
pươi	p ư ơ i |
minơ	m i n ơ |
trốc	t r ố c |
rắt	r ắ t |
nõn	n õ n |
ỏi	ỏ i |
tồm	t ồ m |
choẹt	c h o ẹ t |
lốt	l ố t |
diềm	d i ề m |
huếch	h u ế c h |
ợi	ợ i |
lằm	l ằ m |
kumsusan	k u m s u s a n |
tàng	t à n g |
rã	r ã |
khoắng	k h o ắ n g |
thoá	t h o á |
ngoé	n g o é |
gôn	g ô n |
nhin	n h i n |
ethylene	e t h y l e n e |
cõi	c õ i |
cascadeur	c a s c a d e u r |
chõng	c h õ n g |
nhép	n h é p |
riêu	r i ê u |
nhảo	n h ả o |
cọi	c ọ i |
khẻo	k h ẻ o |
nuông	n u ô n g |
sáng	s á n g |
van	v a n |
xenti	x e n t i |
què	q u è |
tinlà	t i n l à |
tỏng	t ỏ n g |
galena	g a l e n a |
dm	d m |
xit	x i t |
khúng	k h ú n g |
sòa	s ò a |
háng	h á n g |
măngsông	m ă n g s ô n g |
tuế	t u ế |
giờn	g i ờ n |
vải	v ả i |
chẵn	c h ẵ n |
hạch	h ạ c h |
thiu	t h i u |
quèo	q u è o |
gnp	g n p |
rùa	r ù a |
thơ	t h ơ |
cỗ	c ỗ |
lâp	l â p |
găng	g ă n g |
sững	s ữ n g |
luận	l u ậ n |
birr	b i r r |
hổng	h ổ n g |
tắm	t ắ m |
quở	q u ở |
xôđa	x ô đ a |
dợn	d ợ n |
lưng	l ư n g |
guộc	g u ộ c |
typo	t y p o |
loạng	l o ạ n g |
ca	c a |
cừu	c ừ u |
dập	d ậ p |
bơi	b ơ i |
nhúi	n h ú i |
rỏng	r ỏ n g |
nhoét	n h o é t |
chưn	c h ư n |
cpu	c p u |
khượt	k h ư ợ t |
hời	h ờ i |
gabađin	g a b a đ i n |
thợ	t h ợ |
sự	s ự |
chỉnh	c h ỉ n h |
ngoảnh	n g o ả n h |
cholesterol	c h o l e s t e r o l |
tróng	t r ó n g |
nắng	n ắ n g |
mĩm	m ĩ m |
rảng	r ả n g |
fen	f e n |
hố	h ố |
móng	m ó n g |
cuarơ	c u a r ơ |
án	á n |
sẽê	s ẽ ê |
gả	g ả |
chòm	c h ò m |
sường	s ư ờ n g |
quýt	q u ý t |
giướng	g i ư ớ n g |
quánh	q u á n h |
giọi	g i ọ i |
dôn	d ô n |
ngày	n g à y |
vườn	v ư ờ n |
sắng	s ắ n g |
khổn	k h ổ n |
chất	c h ấ t |
mải	m ả i |
nức	n ứ c |
kiện	k i ệ n |
trẹo	t r ẹ o |
nố	n ố |
phệnh	p h ệ n h |
trêu	t r ê u |
sể	s ể |
chuông	c h u ô n g |
nhiệm	n h i ệ m |
trặn	t r ặ n |
polyetylen	p o l y e t y l e n |
soum	s o u m |
cóm	c ó m |
vác	v á c |
chế	c h ế |
loé	l o é |
leone	l e o n e |
mum	m u m |
hoạ	h o ạ |
xõm	x õ m |
đẫn	đ ẫ n |
tảo	t ả o |
trái	t r á i |
bòi	b ò i |
úc	ú c |
console	c o n s o l e |
milli	m i l l i |
uổng	u ổ n g |
phốt	p h ố t |
áp	á p |
sụm	s ụ m |
hiê	h i ê |
yêu	y ê u |
xuỳ	x u ỳ |
nhui	n h u i |
trớt	t r ớ t |
sư	s ư |
đọc	đ ọ c |
ưa	ư a |
ớm	ớ m |
antipirin	a n t i p i r i n |
trới	t r ớ i |
đáng	đ á n g |
silicium	s i l i c i u m |
khương	k h ư ơ n g |
sần	s ầ n |
isp	i s p |
giường	g i ư ờ n g |
api	a p i |
mộc	m ộ c |
khê	k h ê |
bưng	b ư n g |
nhấc	n h ấ c |
áo	á o |
dấp	d ấ p |
dan	d a n |
phổng	p h ổ n g |
ngơm	n g ơ m |
đướu	đ ư ớ u |
sột	s ộ t |
dung	d u n g |
đánh	đ á n h |
nđcp	n đ c p |
thấu	t h ấ u |
đườn	đ ư ờ n |
mấp	m ấ p |
voi	v o i |
khản	k h ả n |
ệch	ệ c h |
khớ	k h ớ |
dầm	d ầ m |
clo	c l o |
mem	m e m |
tói	t ó i |
thuộc	t h u ộ c |
vòng	v ò n g |
loắn	l o ắ n |
mafia	m a f i a |
prôton	p r ô t o n |
rửng	r ử n g |
âớu	â ớ u |
trổi	t r ổ i |
đày	đ à y |
nhiệt	n h i ệ t |
sen	s e n |
gùng	g ù n g |
hỗng	h ỗ n g |
nhơm	n h ơ m |
chuốc	c h u ố c |
chợt	c h ợ t |
nham	n h a m |
trải	t r ả i |
ngố	n g ố |
khiễng	k h i ễ n g |
hẻm	h ẻ m |
giếc	g i ế c |
hán	h á n |
xõng	x õ n g |
nát	n á t |
hắn	h ắ n |
xoạc	x o ạ c |
úp	ú p |
lốn	l ố n |
mn	m n |
số	s ố |
trèm	t r è m |
khoảnh	k h o ả n h |
lếch	l ế c h |
ướt	ư ớ t |
cợp	c ợ p |
đấm	đ ấ m |
chậy	c h ậ y |
đoạ	đ o ạ |
doãng	d o ã n g |
hlv	h l v |
lượt	l ư ợ t |
dả	d ả |
sacaroza	s a c a r o z a |
ngỗng	n g ỗ n g |
dich	d i c h |
blackberry	b l a c k b e r r y |
dân	d â n |
sỏ	s ỏ |
mưởi	m ư ở i |
cordoba	c o r d o b a |
duẩn	d u ẩ n |
crô	c r ô |
chuếch	c h u ế c h |
mấtđiện	m ấ t đ i ệ n |
khống	k h ố n g |
nháo	n h á o |
ngườ	n g ư ờ |
riết	r i ế t |
thịt	t h ị t |
ụp	ụ p |
sâu	s â u |
kruna	k r u n a |
ngờõ	n g ờ õ |
ù	ù |
quẹo	q u ẹ o |
xuê	x u ê |
ngo	n g o |
trạng	t r ạ n g |
gốm	g ố m |
chán	c h á n |
malaysia	m a l a y s i a |
bugi	b u g i |
vơ	v ơ |
hướm	h ư ớ m |
làm	l à m |
danh	d a n h |
trản	t r ả n |
môi	m ô i |
thâu	t h â u |
đằn	đ ằ n |
thằn	t h ằ n |
cầncung	c ầ n c u n g |
đèm	đ è m |
thắng	t h ắ n g |
sunfuric	s u n f u r i c |
pháy	p h á y |
rơnghen	r ơ n g h e n |
gẵng	g ẵ n g |
xrê	x r ê |
vút	v ú t |
giần	g i ầ n |
thinh	t h i n h |
cửm	c ử m |
lẹt	l ẹ t |
trào	t r à o |
khó	k h ó |
chiêm	c h i ê m |
ngút	n g ú t |
tananh	t a n a n h |
râm	r â m |
xàng	x à n g |
mai	m a i |
ta	t a |
trảu	t r ả u |
lazăng	l a z ă n g |
santonin	s a n t o n i n |
đát	đ á t |
khắm	k h ắ m |
ngõi	n g õ i |
dội	d ộ i |
dioptr	d i o p t r |
binh	b i n h |
đỡ	đ ỡ |
hiu	h i u |
đều	đ ề u |
goát	g o á t |
clê	c l ê |
nghe	n g h e |
gourde	g o u r d e |
răn	r ă n |
tũn	t ũ n |
thót	t h ó t |
ị	ị |
kudzu	k u d z u |
turbin	t u r b i n |
cuộn	c u ộ n |
trố	t r ố |
lày	l à y |
distribution	d i s t r i b u t i o n |
lất	l ấ t |
ẹc	ẹ c |
dịu	d ị u |
tửng	t ử n g |
phẩy	p h ẩ y |
truột	t r u ộ t |
quên	q u ê n |
xả	x ả |
nhàm	n h à m |
rầy	r ầ y |
loằng	l o ằ n g |
xêu	x ê u |
dưỡng	d ư ỡ n g |
tệ	t ệ |
codeine	c o d e i n e |
mếch	m ế c h |
ngán	n g á n |
bẹp	b ẹ p |
đạch	đ ạ c h |
niềng	n i ề n g |
vani	v a n i |
vậy	v ậ y |
chớn	c h ớ n |
quào	q u à o |
thảng	t h ả n g |
xilanh	x i l a n h |
liểng	l i ể n g |
đảm	đ ả m |
rồi	r ồ i |
loài	l o à i |
dướn	d ư ớ n |
hẹn	h ẹ n |
ới	ớ i |
bết	b ế t |
en	e n |
khăng	k h ă n g |
xoe	x o e |
nhựt	n h ự t |
hườm	h ư ờ m |
rót	r ó t |
siêng	s i ê n g |
ôxy	ô x y |
hều	h ề u |
bọc	b ọ c |
nôn	n ô n |
hom	h o m |
căm	c ă m |
xừng	x ừ n g |
ebonit	e b o n i t |
dự	d ự |
xung	x u n g |
lôm	l ô m |
ngú	n g ú |
trẩu	t r ẩ u |
patanh	p a t a n h |
phựt	p h ự t |
khán	k h á n |
sỹ	s ỹ |
treo	t r e o |
tuấn	t u ấ n |
đối	đ ố i |
chờ	c h ờ |
chủa	c h ủ a |
mến	m ế n |
duối	d u ố i |
ất	ấ t |
đo	đ o |
dàng	d à n g |
vixcô	v i x c ô |
lìn	l ì n |
trít	t r í t |
khiến	k h i ế n |
bìu	b ì u |
champa	c h a m p a |
cạy	c ạ y |
ngại	n g ạ i |
loanh	l o a n h |
ấy	ấ y |
thản	t h ả n |
pài	p à i |
đoài	đ o à i |
phiết	p h i ế t |
ỏng	ỏ n g |
vàng	v à n g |
mố	m ố |
tễ	t ễ |
chích	c h í c h |
quoắt	q u o ắ t |
rỏ	r ỏ |
nấc	n ấ c |
ọe	ọ e |
nhợ	n h ợ |
hón	h ó n |
phảng	p h ả n g |
oàng	o à n g |
mbit	m b i t |
nhàn	n h à n |
seri	s e r i |
dẫy	d ẫ y |
trụi	t r ụ i |
bẩy	b ẩ y |
kém	k é m |
tuân	t u â n |
xép	x é p |
bận	b ậ n |
thìn	t h ì n |
choẹ	c h o ẹ |
bứng	b ứ n g |
lỗi	l ỗ i |
lặp	l ặ p |
ụt	ụ t |
nóc	n ó c |
bẩn	b ẩ n |
nhái	n h á i |
đường	đ ư ờ n g |
tiêu	t i ê u |
vền	v ề n |
rế	r ế |
phừng	p h ừ n g |
alcaloid	a l c a l o i d |
ghì	g h ì |
oẻ	o ẻ |
đang	đ a n g |
măngđa	m ă n g đ a |
mân	m â n |
mim	m i m |
lân	l â n |
núp	n ú p |
xáy	x á y |
nẹp	n ẹ p |
giu	g i u |
nhé	n h é |
quyền	q u y ề n |
pan	p a n |
bẽn	b ẽ n |
ớt	ớ t |
cybernetic	c y b e r n e t i c |
tèm	t è m |
xùy	x ù y |
mung	m u n g |
nháng	n h á n g |
thẫn	t h ẫ n |
baht	b a h t |
cẫng	c ẫ n g |
rệ	r ệ |
kên	k ê n |
tò	t ò |
com	c o m |
java	j a v a |
uyển	u y ể n |
biền	b i ề n |
nen	n e n |
chỏi	c h ỏ i |
ngoém	n g o é m |
input	i n p u t |
chọe	c h ọ e |
nải	n ả i |
nò	n ò |
nạng	n ạ n g |
hươm	h ư ơ m |
se	s e |
rười	r ư ờ i |
bim	b i m |
gùi	g ù i |
xồm	x ồ m |
ràm	r à m |
phạo	p h ạ o |
paraffin	p a r a f f i n |
quạ	q u ạ |
xhcn	x h c n |
mô	m ô |
két	k é t |
nay	n a y |
lơng	l ơ n g |
rớ	r ớ |
iode	i o d e |
bản	b ả n |
kingem	k i n g e m |
kiếu	k i ế u |
nghiến	n g h i ế n |
cứu	c ứ u |
oéc	o é c |
xoè	x o è |
dũi	d ũ i |
nảy	n ả y |
kịa	k ị a |
xệ	x ệ |
nghẻn	n g h ẻ n |
quếch	q u ế c h |
rí	r í |
thiển	t h i ể n |
khoen	k h o e n |
rê	r ê |
thuô	t h u ô |
paulus	p a u l u s |
penalty	p e n a l t y |
choàng	c h o à n g |
lấc	l ấ c |
trăn	t r ă n |
kẽo	k ẽ o |
hỡ	h ỡ |
chon	c h o n |
dắm	d ắ m |
niết	n i ế t |
heuristic	h e u r i s t i c |
am	a m |
rịn	r ị n |
dọa	d ọ a |
syndicat	s y n d i c a t |
thồn	t h ồ n |
mảng	m ả n g |
mễ	m ễ |
hùi	h ù i |
liệu	l i ệ u |
quầng	q u ầ n g |
giật	g i ậ t |
khải	k h ả i |
ngoặc	n g o ặ c |
rọng	r ọ n g |
cốn	c ố n |
hồi	h ồ i |
ruối	r u ố i |
tráo	t r á o |
nhau	n h a u |
mếu	m ế u |
lịnh	l ị n h |
bợp	b ợ p |
sẹo	s ẹ o |
dũa	d ũ a |
vữa	v ữ a |
xoẳn	x o ẳ n |
tuệch	t u ệ c h |
tựu	t ự u |
xậu	x ậ u |
chôm	c h ô m |
nhan	n h a n |
format	f o r m a t |
loè	l o è |
mì	m ì |
hí	h í |
lave	l a v e |
nguỵ	n g u ỵ |
nui	n u i |
xác	x á c |
mw	m w |
glixerin	g l i x e r i n |
bội	b ộ i |
lẩy	l ẩ y |
prâng	p r â n g |
khóe	k h ó e |
niềm	n i ề m |
cõng	c õ n g |
súc	s ú c |
khi	k h i |
mắm	m ắ m |
rèo	r è o |
xoang	x o a n g |
bôđê	b ô đ ê |
sặt	s ặ t |
phospho	p h o s p h o |
cưỡng	c ư ỡ n g |
vỗ	v ỗ |
phộng	p h ộ n g |
lươm	l ư ơ m |
hịch	h ị c h |
lụa	l ụ a |
mủi	m ủ i |
oăn	o ă n |
rupiah	r u p i a h |
tém	t é m |
vật	v ậ t |
nhĩn	n h ĩ n |
toé	t o é |
nin	n i n |
noa	n o a |
cỏ	c ỏ |
sịa	s ị a |
qđ	q đ |
panh	p a n h |
píc	p í c |
giạc	g i ạ c |
anopheles	a n o p h e l e s |
giụi	g i ụ i |
khành	k h à n h |
clin	c l i n |
ròi	r ò i |
chiền	c h i ề n |
nhụ	n h ụ |
bãi	b ã i |
đắc	đ ắ c |
chocolate	c h o c o l a t e |
ảm	ả m |
loét	l o é t |
ngoét	n g o é t |
chũi	c h ũ i |
notebook	n o t e b o o k |
ằm	ằ m |
khuyên	k h u y ê n |
đậy	đ ậ y |
trót	t r ó t |
vao	v a o |
lễ	l ễ |
rủ	r ủ |
ngóeo	n g ó e o |
ngà	n g à |
nghĩa	n g h ĩ a |
hé	h é |
xuất	x u ấ t |
điếm	đ i ế m |
chả	c h ả |
caffein	c a f f e i n |
kim	k i m |
hoẹt	h o ẹ t |
ngược	n g ư ợ c |
khằng	k h ằ n g |
glô	g l ô |
toilet	t o i l e t |
cộp	c ộ p |
dần	d ầ n |
bệnh	b ệ n h |
có	c ó |
lũng	l ũ n g |
điêu	đ i ê u |
vietcombank	v i e t c o m b a n k |
khinh	k h i n h |
tetanos	t e t a n o s |
basa	b a s a |
lem	l e m |
nhênh	n h ê n h |
xảm	x ả m |
choác	c h o á c |
hơgơr	h ơ g ơ r |
răng	r ă n g |
nỡ	n ỡ |
fax	f a x |
hò	h ò |
mứa	m ứ a |
gôm	g ô m |
bì	b ì |
quỵt	q u ỵ t |
dật	d ậ t |
piano	p i a n o |
rói	r ó i |
ngóe	n g ó e |
men	m e n |
kẹt	k ẹ t |
xưng	x ư n g |
năm	n ă m |
diết	d i ế t |
guộn	g u ộ n |
giại	g i ạ i |
tỗng	t ỗ n g |
bại	b ạ i |
phẹt	p h ẹ t |
quota	q u o t a |
rồng	r ồ n g |
ron	r o n |
thụy	t h ụ y |
lửng	l ử n g |
ngắt	n g ắ t |
v	v |
aminoacid	a m i n o a c i d |
biệt	b i ệ t |
khèng	k h è n g |
lỉnh	l ỉ n h |
ngoẳng	n g o ẳ n g |
vu	v u |
cảy	c ả y |
đầy	đ ầ y |
pấc	p ấ c |
bính	b í n h |
thình	t h ì n h |
líp	l í p |
rọ	r ọ |
ar	a r |
vừa	v ừ a |
đìn	đ ì n |
tróm	t r ó m |
cũ	c ũ |
toe	t o e |
ặc	ặ c |
anh	a n h |
deci	d e c i |
khoác	k h o á c |
trếnh	t r ế n h |
don	d o n |
module	m o d u l e |
mệnh	m ệ n h |
bỏng	b ỏ n g |
output	o u t p u t |
nẩy	n ẩ y |
cuba	c u b a |
dướng	d ư ớ n g |
rôngđô	r ô n g đ ô |
moay	m o a y |
ngất	n g ấ t |
hạm	h ạ m |
ge	g e |
vưng	v ư n g |
hóc	h ó c |
sốt	s ố t |
mùng	m ù n g |
rắp	r ắ p |
dịệp	d ị ệ p |
hreng	h r e n g |
kre	k r e |
uỵch	u ỵ c h |
tannin	t a n n i n |
xèo	x è o |
cừ	c ừ |
giàn	g i à n |
khươn	k h ư ơ n |
atk	a t k |
dổm	d ổ m |
triêng	t r i ê n g |
rắn	r ắ n |
quáng	q u á n g |
rén	r é n |
file	f i l e |
săng	s ă n g |
giòi	g i ò i |
nhơi	n h ơ i |
mev	m e v |
thụng	t h ụ n g |
thăn	t h ă n |
xón	x ó n |
thụt	t h ụ t |
thát	t h á t |
rèm	r è m |
mấn	m ấ n |
bệu	b ệ u |
rụa	r ụ a |
trảnh	t r ả n h |
tạt	t ạ t |
săn	s ă n |
vun	v u n |
ngầu	n g ầ u |
ngạt	n g ạ t |
quẹt	q u ẹ t |
kỉ	k ỉ |
tango	t a n g o |
arsenic	a r s e n i c |
dụng	d ụ n g |
truồng	t r u ồ n g |
mayô	m a y ô |
kêu	k ê u |
phom	p h o m |
luông	l u ô n g |
biện	b i ệ n |
bái	b á i |
àm	à m |
kilomet	k i l o m e t |
đầu	đ ầ u |
sẩy	s ẩ y |
lì	l ì |
muỗi	m u ỗ i |
q	q |
khiết	k h i ế t |
chếch	c h ế c h |
đóm	đ ó m |
quyết	q u y ế t |
glaucom	g l a u c o m |
phê	p h ê |
đông	đ ô n g |
xử	x ử |
mơi	m ơ i |
concerto	c o n c e r t o |
đọai	đ ọ a i |
nhít	n h í t |
vừng	v ừ n g |
ht	h t |
côngtơ	c ô n g t ơ |
rôm	r ô m |
nhợp	n h ợ p |
sia	s i a |
liệp	l i ệ p |
chửng	c h ử n g |
ton	t o n |
lạt	l ạ t |
tọng	t ọ n g |
váy	v á y |
làng	l à n g |
phù	p h ù |
giềng	g i ề n g |
cộc	c ộ c |
etxăng	e t x ă n g |
đĩnh	đ ĩ n h |
đúa	đ ú a |
tao	t a o |
vửng	v ử n g |
cờ	c ờ |
sai	s a i |
sấn	s ấ n |
đà	đ à |
rịm	r ị m |
cát	c á t |
chan	c h a n |
fomanđehit	f o m a n đ e h i t |
quệnh	q u ệ n h |
sực	s ự c |
xôi	x ô i |
chẻn	c h ẻ n |
á	á |
tốn	t ố n |
nuối	n u ố i |
dòi	d ò i |
quá	q u á |
tâa	t â a |
biết	b i ế t |
bắp	b ắ p |
nọi	n ọ i |
cd	c d |
nhố	n h ố |
cologa	c o l o g a |
rô	r ô |
nhuốc	n h u ố c |
lũa	l ũ a |
nán	n á n |
quận	q u ậ n |
beng	b e n g |
lòa	l ò a |
thưa	t h ư a |
xù	x ù |
chước	c h ư ớ c |
nai	n a i |
iso	i s o |
đèn	đ è n |
lềnh	l ề n h |
ngời	n g ờ i |
ngốn	n g ố n |
đậm	đ ậ m |
nguẩy	n g u ẩ y |
bis	b i s |
xoẹt	x o ẹ t |
học	h ọ c |
chưng	c h ư n g |
gãi	g ã i |
giễu	g i ễ u |
carbon	c a r b o n |
omicron	o m i c r o n |
gióc	g i ó c |
si	s i |
tuệ	t u ệ |
xuẩn	x u ẩ n |
pạ	p ạ |
cất	c ấ t |
vêu	v ê u |
sình	s ì n h |
buội	b u ộ i |
miến	m i ế n |
uỳnh	u ỳ n h |
xập	x ậ p |
suật	s u ậ t |
magnetit	m a g n e t i t |
đon	đ o n |
lậu	l ậ u |
nhông	n h ô n g |
loi	l o i |
ip	i p |
khoai	k h o a i |
giới	g i ớ i |
díp	d í p |
cười	c ư ờ i |
litas	l i t a s |
gie	g i e |
xoi	x o i |
jordan	j o r d a n |
tạm	t ạ m |
cù	c ù |
rụi	r ụ i |
gừ	g ừ |
gấp	g ấ p |
thửng	t h ử n g |
bi	b i |
ceo	c e o |
ngươn	n g ư ơ n |
ém	é m |
nưa	n ư a |
xì	x ì |
đrát	đ r á t |
muời	m u ờ i |
cũng	c ũ n g |
rondo	r o n d o |
đòi	đ ò i |
xòm	x ò m |
ý	ý |
cacbon	c a c b o n |
rỗi	r ỗ i |
bụm	b ụ m |
mầng	m ầ n g |
cẩu	c ẩ u |
ừa	ừ a |
vó	v ó |
big	b i g |
đenta	đ e n t a |
ròng	r ò n g |
nẫy	n ẫ y |
nục	n ụ c |
xoen	x o e n |
ngục	n g ụ c |
monome	m o n o m e |
ừng	ừ n g |
ngả	n g ả |
giang	g i a n g |
gara	g a r a |
kỷ	k ỷ |
xoèn	x o è n |
mế	m ế |
rặm	r ặ m |
vọt	v ọ t |
nghể	n g h ể |
carbonate	c a r b o n a t e |
huyện	h u y ệ n |
xộp	x ộ p |
thon	t h o n |
ầng	ầ n g |
nhỉnh	n h ỉ n h |
magnesium	m a g n e s i u m |
uar	u a r |
vks	v k s |
memristor	m e m r i s t o r |
vector	v e c t o r |
jiang	j i a n g |
dẻ	d ẻ |
lồ	l ồ |
blông	b l ô n g |
chặp	c h ặ p |
đưng	đ ư n g |
qũy	q ũ y |
denar	d e n a r |
thuể	t h u ể |
bụ	b ụ |
ru	r u |
tănggô	t ă n g g ô |
dít	d í t |
mím	m í m |
ên	ê n |
éc	é c |
xửng	x ử n g |
kinacrin	k i n a c r i n |
vón	v ó n |
đớ	đ ớ |
nhõi	n h õ i |
quỳ	q u ỳ |
kềm	k ề m |
rút	r ú t |
dắc	d ắ c |
kì	k ì |
gilê	g i l ê |
puli	p u l i |
thèn	t h è n |
chin	c h i n |
ởi	ở i |
pơ	p ơ |
thục	t h ụ c |
pound	p o u n d |
the	t h e |
rả	r ả |
vén	v é n |
ngoạch	n g o ạ c h |
pencaksilat	p e n c a k s i l a t |
vớ	v ớ |
tic	t i c |
xirô	x i r ô |
phưng	p h ư n g |
đốc	đ ố c |
nhằm	n h ằ m |
tiếng	t i ế n g |
bong	b o n g |
xâm	x â m |
pa	p a |
sòm	s ò m |
fuốc	f u ố c |
tặc	t ặ c |
ngắn	n g ắ n |
centi	c e n t i |
trèn	t r è n |
phăn	p h ă n |
na	n a |
gỗ	g ỗ |
cua	c u a |
tè	t è |
macro	m a c r o |
chiếm	c h i ế m |
hổn	h ổ n |
góc	g ó c |
lớt	l ớ t |
phula	p h u l a |
trách	t r á c h |
lẽo	l ẽ o |
táp	t á p |
đì	đ ì |
hinh	h i n h |
pc	p c |
ngồí	n g ồ í |
xier	x i e r |
lòm	l ò m |
aids	a i d s |
ngập	n g ậ p |
tuềnh	t u ề n h |
xưởng	x ư ở n g |
tài	t à i |
giầu	g i ầ u |
toát	t o á t |
sớt	s ớ t |
gách	g á c h |
dai	d a i |
thẹp	t h ẹ p |
lưỡì	l ư ỡ ì |
ngoong	n g o o n g |
nhốc	n h ố c |
permanganate	p e r m a n g a n a t e |
chú	c h ú |
e	e |
trỗi	t r ỗ i |
giẽ	g i ẽ |
lộn	l ộ n |
tủng	t ủ n g |
phiền	p h i ề n |
sró	s r ó |
chẫm	c h ẫ m |
thắp	t h ắ p |
chẹp	c h ẹ p |
bẽ	b ẽ |
hám	h á m |
só	s ó |
uất	u ấ t |
mắng	m ắ n g |
adrenalin	a d r e n a l i n |
tưới	t ư ớ i |
nhong	n h o n g |
cmtnd	c m t n d |
thõa	t h õ a |
búng	b ú n g |
khuy	k h u y |
shekel	s h e k e l |
bầng	b ầ n g |
lát	l á t |
bulông	b u l ô n g |
goá	g o á |
vậytheo	v ậ y t h e o |
vượn	v ư ợ n |
azot	a z o t |
trệch	t r ệ c h |
bạo	b ạ o |
lảnh	l ả n h |
phú	p h ú |
phị	p h ị |
ngùi	n g ù i |
quẻ	q u ẻ |
kênh	k ê n h |
mới	m ớ i |
ậng	ậ n g |
natri	n a t r i |
rụp	r ụ p |
ngót	n g ó t |
giọc	g i ọ c |
tôngđơ	t ô n g đ ơ |
côngtắc	c ô n g t ắ c |
khụy	k h ụ y |
trém	t r é m |
vetxi	v e t x i |
bộp	b ộ p |
oặt	o ặ t |
tai	t a i |
lớ	l ớ |
giát	g i á t |
nhựa	n h ự a |
cartel	c a r t e l |
nhược	n h ư ợ c |
lớp	l ớ p |
rúi	r ú i |
úng	ú n g |
côn	c ô n |
nhện	n h ệ n |
ngồn	n g ồ n |
phlạo	p h l ạ o |
thé	t h é |
sặm	s ặ m |
báo	b á o |
quít	q u í t |
u	u |
hét	h é t |
cơm	c ơ m |
chảy	c h ả y |
sên	s ê n |
dà	d à |
xạo	x ạ o |
vược	v ư ợ c |
j	j |
trị	t r ị |
hải	h ả i |
cốt	c ố t |
gần	g ầ n |
trẹt	t r ẹ t |
chình	c h ì n h |
mén	m é n |
panô	p a n ô |
xổm	x ổ m |
khệch	k h ệ c h |
lủi	l ủ i |
hẽm	h ẽ m |
soẹt	s o ẹ t |
thôihà	t h ô i h à |
giua	g i u a |
nghệ	n g h ệ |
phũ	p h ũ |
họe	h ọ e |
cỡi	c ỡ i |
lọp	l ọ p |
be	b e |
offline	o f f l i n e |
luân	l u â n |
khay	k h a y |
ngan	n g a n |
líu	l í u |
oằn	o ằ n |
nsưt	n s ư t |
biểu	b i ể u |
nhám	n h á m |
rơle	r ơ l e |
quyến	q u y ế n |
giai	g i a i |
quẫy	q u ẫ y |
halogen	h a l o g e n |
dựa	d ự a |
bươu	b ư ơ u |
lừng	l ừ n g |
tìền	t ì ề n |
tiếu	t i ế u |
xớt	x ớ t |
đổng	đ ổ n g |
lởn	l ở n |
phiện	p h i ệ n |
tròm	t r ò m |
đắk	đ ắ k |
cáilịch	c á i l ị c h |
co	c o |
thượt	t h ư ợ t |
phọt	p h ọ t |
bủng	b ủ n g |
chỗ	c h ỗ |
vagông	v a g ô n g |
còm	c ò m |
vạt	v ạ t |
ọc	ọ c |
nướu	n ư ớ u |
ú	ú |
ngửng	n g ử n g |
hocmon	h o c m o n |
nguầy	n g u ầ y |
cacbua	c a c b u a |
sách	s á c h |
kê	k ê |
khoăn	k h o ă n |
chớp	c h ớ p |
xoan	x o a n |
hấy	h ấ y |
bakelite	b a k e l i t e |
lóa	l ó a |
tưởi	t ư ở i |
thớm	t h ớ m |
sgk	s g k |
nhồi	n h ồ i |
quẳm	q u ẳ m |
ne	n e |
ba	b a |
ảnh	ả n h |
hai	h a i |
gô	g ô |
lăclê	l ă c l ê |
hàn	h à n |
aỏn	a ỏ n |
cục	c ụ c |
nhụa	n h ụ a |
nhuần	n h u ầ n |
folklor	f o l k l o r |
gâm	g â m |
lẫy	l ẫ y |
iot	i o t |
toài	t o à i |
cộng	c ộ n g |
gắt	g ắ t |
choa	c h o a |
khới	k h ớ i |
choái	c h o á i |
xẹc	x ẹ c |
mòm	m ò m |
víu	v í u |
fut	f u t |
khẹc	k h ẹ c |
bẹ	b ẹ |
bọt	b ọ t |
cộm	c ộ m |
rựa	r ự a |
microcomputer	m i c r o c o m p u t e r |
cũn	c ũ n |
xuyên	x u y ê n |
chạồm	c h ạ ồ m |
xuỵt	x u ỵ t |
hâm	h â m |
lìu	l ì u |
hyperbol	h y p e r b o l |
ngọn	n g ọ n |
tự	t ự |
trỉa	t r ỉ a |
sơm	s ơ m |
ngửi	n g ử i |
chuyển	c h u y ể n |
apatite	a p a t i t e |
đảy	đ ả y |
culon	c u l o n |
vang	v a n g |
ngọc	n g ọ c |
lụ	l ụ |
ríu	r í u |
vện	v ệ n |
ferit	f e r i t |
hđnd	h đ n d |
dạy	d ạ y |
khẩn	k h ẩ n |
ựa	ự a |
téch	t é c h |
ghếch	g h ế c h |
ghẻ	g h ẻ |
calibre	c a l i b r e |
amygdal	a m y g d a l |
giữ	g i ữ |
ngồi	n g ồ i |
ngòi	n g ò i |
chữ	c h ữ |
xẻn	x ẻ n |
chốc	c h ố c |
lam	l a m |
ghin	g h i n |
chứ	c h ứ |
xắn	x ắ n |
scô	s c ô |
êbur	ê b u r |
roh	r o h |
côngxon	c ô n g x o n |
hãy	h ã y |
dẹo	d ẹ o |
brôm	b r ô m |
lới	l ớ i |
xóm	x ó m |
yêng	y ê n g |
kè	k è |
amiđan	a m i đ a n |
đỉnh	đ ỉ n h |
macgarin	m a c g a r i n |
lĩnh	l ĩ n h |
thiện	t h i ệ n |
đóc	đ ó c |
vọng	v ọ n g |
chạp	c h ạ p |
sulfate	s u l f a t e |
bói	b ó i |
tăcte	t ă c t e |
khuynh	k h u y n h |
xum	x u m |
niêu	n i ê u |
đem	đ e m |
phích	p h í c h |
gịa	g ị a |
plasma	p l a s m a |
gưỡng	g ư ỡ n g |
ruồng	r u ồ n g |
xoạng	x o ạ n g |
cập	c ậ p |
bui	b u i |
tơ	t ơ |
vặt	v ặ t |
hanh	h a n h |
đán	đ á n |
top	t o p |
lái	l á i |
pom	p o m |
ruốt	r u ố t |
cào	c à o |
xúc	x ú c |
chư	c h ư |
trùm	t r ù m |
xức	x ứ c |
miếng	m i ế n g |
cuộc	c u ộ c |
rạp	r ạ p |
sới	s ớ i |
tiền	t i ề n |
khlá	k h l á |
nhuồn	n h u ồ n |
gọ	g ọ |
otto	o t t o |
ng	n g |
đứ	đ ứ |
non	n o n |
khan	k h a n |
bãng	b ã n g |
rịt	r ị t |
vào	v à o |
hỏi	h ỏ i |
han	h a n |
xta	x t a |
ỡm	ỡ m |
mập	m ậ p |
đòng	đ ò n g |
bọ	b ọ |
phề	p h ề |
nhiễu	n h i ễ u |
hoải	h o ả i |
nhướng	n h ư ớ n g |
nừng	n ừ n g |
rúm	r ú m |
khép	k h é p |
lênin	l ê n i n |
hìinh	h ì i n h |
zeta	z e t a |
sẹm	s ẹ m |
bohri	b o h r i |
bau	b a u |
bưa	b ư a |
léo	l é o |
trat	t r a t |
luôm	l u ô m |
dô	d ô |
xiểng	x i ể n g |
ngụp	n g ụ p |
cul	c u l |
thuổng	t h u ổ n g |
interj	i n t e r j |
đọ	đ ọ |
chặt	c h ặ t |
phosphorite	p h o s p h o r i t e |
rởn	r ở n |
trườn	t r ư ờ n |
luyến	l u y ế n |
cí	c í |
quèn	q u è n |
morphin	m o r p h i n |
cay	c a y |
cassette	c a s s e t t e |
mán	m á n |
móp	m ó p |
hẫu	h ẫ u |
dĩa	d ĩ a |
hertz	h e r t z |
ngẳn	n g ẳ n |
lược	l ư ợ c |
trai	t r a i |
chít	c h í t |
morasse	m o r a s s e |
cại	c ạ i |
dất	d ấ t |
can	c a n |
sàng	s à n g |
dắng	d ắ n g |
trực	t r ự c |
dnh	d n h |
đách	đ á c h |
phản	p h ả n |
gu	g u |
cận	c ậ n |
esperanto	e s p e r a n t o |
hục	h ụ c |
đoi	đ o i |
kađai	k a đ a i |
ham	h a m |
hiếp	h i ế p |
bunker	b u n k e r |
thộp	t h ộ p |
sởi	s ở i |
nươ	n ư ơ |
xé	x é |
anzus	a n z u s |
xăng	x ă n g |
rufiyaa	r u f i y a a |
tiệt	t i ệ t |
đọa	đ ọ a |
xelulo	x e l u l o |
láo	l á o |
magma	m a g m a |
thuỵ	t h u ỵ |
quằn	q u ằ n |
rắc	r ắ c |
miểu	m i ể u |
tây	t â y |
thượng	t h ư ợ n g |
soa	s o a |
nhụi	n h ụ i |
sám	s á m |
latinh	l a t i n h |
thúi	t h ú i |
ủ	ủ |
rạm	r ạ m |
nấy	n ấ y |
xẹt	x ẹ t |
chưỡng	c h ư ỡ n g |
soải	s o ả i |
kếch	k ế c h |
kiểm	k i ể m |
acten	a c t e n |
thận	t h ậ n |
thĩ	t h ĩ |
xương	x ư ơ n g |
nghìnđó	n g h ì n đ ó |
bợn	b ợ n |
phiệu	p h i ệ u |
khoắm	k h o ắ m |
hươu	h ư ơ u |
bolivar	b o l i v a r |
hù	h ù |
khuýp	k h u ý p |
ngằn	n g ằ n |
kiêng	k i ê n g |
gay	g a y |
khấn	k h ấ n |
nêu	n ê u |
vụng	v ụ n g |
nhản	n h ả n |
becgiê	b e c g i ê |
spê	s p ê |
bòng	b ò n g |
bám	b á m |
verst	v e r s t |
vẫn	v ẫ n |
amin	a m i n |
xèn	x è n |
vuông	v u ô n g |
lang	l a n g |
chịa	c h ị a |
anode	a n o d e |
hoa	h o a |
ặp	ặ p |
nhung	n h u n g |
tăngxin	t ă n g x i n |
nghét	n g h é t |
bismut	b i s m u t |
nghiệm	n g h i ệ m |
ghiđông	g h i đ ô n g |
nakfa	n a k f a |
hó	h ó |
nhũng	n h ũ n g |
cru	c r u |
rện	r ệ n |
trom	t r o m |
đên	đ ê n |
đãy	đ ã y |
oách	o á c h |
doàng	d o à n g |
khuya	k h u y a |
chậc	c h ậ c |
cược	c ư ợ c |
mẩn	m ẩ n |
bé	b é |
xọe	x ọ e |
ẹo	ẹ o |
tuếch	t u ế c h |
bỗng	b ỗ n g |
xốc	x ố c |
ích	í c h |
siphon	s i p h o n |
loen	l o e n |
lươn	l ư ơ n |
bè	b è |
thức	t h ứ c |
nốc	n ố c |
plas	p l a s |
thuỷ	t h u ỷ |
ngộc	n g ộ c |
xạm	x ạ m |
domino	d o m i n o |
gic	g i c |
măn	m ă n |
tợp	t ợ p |
toàng	t o à n g |
đọng	đ ọ n g |
catxet	c a t x e t |
nín	n í n |
ksmt	k s m t |
đip	đ i p |
khui	k h u i |
ngộp	n g ộ p |
điẹn	đ i ẹ n |
khoáy	k h o á y |
giàng	g i à n g |
huốt	h u ố t |
varơi	v a r ơ i |
rượn	r ư ợ n |
thoai	t h o a i |
gốc	g ố c |
oàm	o à m |
gận	g ậ n |
tõng	t õ n g |
ẫm	ẫ m |
bợm	b ợ m |
chĩa	c h ĩ a |
cuốc	c u ố c |
trùng	t r ù n g |
héc	h é c |
đừng	đ ừ n g |
lít	l í t |
nhu	n h u |
tọp	t ọ p |
quẩng	q u ẩ n g |
thớt	t h ớ t |
dạt	d ạ t |
nhí	n h í |
nhíp	n h í p |
thiệp	t h i ệ p |
máu	m á u |
láp	l á p |
muốn	m u ố n |
cáp	c á p |
fahrenheit	f a h r e n h e i t |
hiến	h i ế n |
chốp	c h ố p |
hác	h á c |
rià	r i à |
deca	d e c a |
phời	p h ờ i |
gdp	g d p |
mậu	m ậ u |
xuề	x u ề |
ngô	n g ô |
barem	b a r e m |
chắn	c h ắ n |
cùa	c ù a |
rin	r i n |
bbc	b b c |
audio	a u d i o |
ellipse	e l l i p s e |
nhậy	n h ậ y |
bỗ	b ỗ |
cskh	c s k h |
huýt	h u ý t |
têt	t ê t |
hoặn	h o ặ n |
lể	l ể |
gàng	g à n g |
ôxít	ô x í t |
hơp	h ơ p |
thác	t h á c |
lành	l à n h |
thướng	t h ư ớ n g |
hạc	h ạ c |
điạ	đ i ạ |
xừ	x ừ |
tua	t u a |
xán	x á n |
thoòng	t h o ò n g |
nhú	n h ú |
tẽ	t ẽ |
vết	v ế t |
dũng	d ũ n g |
chàu	c h à u |
nhâu	n h â u |
trì	t r ì |
trao	t r a o |
tậu	t ậ u |
giấy	g i ấ y |
glu	g l u |
sỉa	s ỉ a |
cl	c l |
ghính	g h í n h |
ghế	g h ế |
ết	ế t |
chèm	c h è m |
sòng	s ò n g |
dụt	d ụ t |
xớp	x ớ p |
đòm	đ ò m |
thôn	t h ô n |
bú	b ú |
lêu	l ê u |
đìu	đ ì u |
tăn	t ă n |
dốc	d ố c |
rẹo	r ẹ o |
quàn	q u à n |
phây	p h â y |
lọt	l ọ t |
máng	m á n g |
online	o n l i n e |
kền	k ề n |
vạng	v ạ n g |
tìn	t ì n |
bềnh	b ề n h |
thông	t h ô n g |
ải	ả i |
suý	s u ý |
tải	t ả i |
sợ	s ợ |
vy	v y |
rìa	r ì a |
lịu	l ị u |
trừu	t r ừ u |
hrê	h r ê |
tuổi	t u ổ i |
bây	b â y |
lắc	l ắ c |
trổ	t r ổ |
insulin	i n s u l i n |
bìm	b ì m |
hãn	h ã n |
cháo	c h á o |
loắt	l o ắ t |
dãn	d ã n |
feldspat	f e l d s p a t |
nành	n à n h |
sừng	s ừ n g |
rác	r á c |
chỉa	c h ỉ a |
lei	l e i |
hước	h ư ớ c |
tóc	t ó c |
rĩ	r ĩ |
mái	m á i |
thẳm	t h ẳ m |
hoe	h o e |
đụp	đ ụ p |
gộp	g ộ p |
sb	s b |
bộng	b ộ n g |
sựng	s ự n g |
xửa	x ử a |
cời	c ờ i |
bừng	b ừ n g |
trợt	t r ợ t |
giếng	g i ế n g |
rão	r ã o |
chềm	c h ề m |
kđrao	k đ r a o |
thoải	t h o ả i |
xoáy	x o á y |
anbumin	a n b u m i n |
phosphorit	p h o s p h o r i t |
account	a c c o u n t |
tường	t ư ờ n g |
ao	a o |
almanac	a l m a n a c |
tót	t ó t |
hút	h ú t |
lí	l í |
sèo	s è o |
gục	g ụ c |
ngoe	n g o e |
nữ	n ữ |
ố	ố |
cầy	c ầ y |
chệp	c h ệ p |
phổí	p h ổ í |
ngau	n g a u |
jen	j e n |
vui	v u i |
stác	s t á c |
ong	o n g |
loáng	l o á n g |
rong	r o n g |
pê	p ê |
xuống	x u ố n g |
côngxectô	c ô n g x e c t ô |
máy	m á y |
ro	r o |
krung	k r u n g |
dẩy	d ẩ y |
quẫn	q u ẫ n |
xơm	x ơ m |
quay	q u a y |
bromure	b r o m u r e |
download	d o w n l o a d |
nghẹ	n g h ẹ |
xìu	x ì u |
basalt	b a s a l t |
dảnh	d ả n h |
rand	r a n d |
giúp	g i ú p |
click	c l i c k |
phất	p h ấ t |
đinh	đ i n h |
nhãn	n h ã n |
trompet	t r o m p e t |
phìu	p h ì u |
tẻ	t ẻ |
lay	l a y |
catket	c a t k e t |
ngõng	n g õ n g |
hiệt	h i ệ t |
nghít	n g h í t |
dâm	d â m |
được	đ ư ợ c |
lỉm	l ỉ m |
khía	k h í a |
nhỡ	n h ỡ |
kung	k u n g |
pây	p â y |
mồn	m ồ n |
quằm	q u ằ m |
rể	r ể |
dứa	d ứ a |
bromua	b r o m u a |
bắc	b ắ c |
xều	x ề u |
nút	n ú t |
xoong	x o o n g |
uế	u ế |
qụy	q ụ y |
lộ	l ộ |
bẻ	b ẻ |
lúi	l ú i |
gắn	g ắ n |
rha	r h a |
chững	c h ữ n g |
vatu	v a t u |
kếu	k ế u |
vé	v é |
càu	c à u |
camera	c a m e r a |
đời	đ ờ i |
xục	x ụ c |
thẹo	t h ẹ o |
chợp	c h ợ p |
trận	t r ậ n |
trình	t r ì n h |
mõ	m õ |
nươi	n ư ơ i |
hoẵng	h o ẵ n g |
rõi	r õ i |
xơi	x ơ i |
ngái	n g á i |
bấc	b ấ c |
gao	g a o |
véo	v é o |
phón	p h ó n |
chọc	c h ọ c |
nhún	n h ú n |
tần	t ầ n |
trợthông	t r ợ t h ô n g |
ha	h a |
as	a s |
hu	h u |
diễm	d i ễ m |
phrăng	p h r ă n g |
phím	p h í m |
qùy	q ù y |
nắm	n ắ m |
bặc	b ặ c |
germanium	g e r m a n i u m |
lề	l ề |
khai	k h a i |
chút	c h ú t |
glucid	g l u c i d |
hoăm	h o ă m |
hẩu	h ẩ u |
posteriori	p o s t e r i o r i |
xình	x ì n h |
dớt	d ớ t |
khói	k h ó i |
oxy	o x y |
nón	n ó n |
hattrick	h a t t r i c k |
chở	c h ở |
dúm	d ú m |
nguôi	n g u ô i |
toẹt	t o ẹ t |
xpê	x p ê |
toái	t o á i |
xoai	x o a i |
đêm	đ ê m |
sắp	s ắ p |
hảng	h ả n g |
đênh	đ ê n h |
mẹt	m ẹ t |
thoàn	t h o à n |
khát	k h á t |
lướt	l ư ớ t |
rocket	r o c k e t |
béo	b é o |
dram	d r a m |
cháng	c h á n g |
dấm	d ấ m |
nhừ	n h ừ |
sủa	s ủ a |
dá	d á |
triện	t r i ệ n |
hối	h ố i |
leu	l e u |
minh	m i n h |
sã	s ã |
đẻ	đ ẻ |
wiki	w i k i |
ràn	r à n |
karaoke	k a r a o k e |
dìa	d ì a |
nghịu	n g h ị u |
ngớn	n g ớ n |
mưới	m ư ớ i |
vôlăng	v ô l ă n g |
sảo	s ả o |
cọm	c ọ m |
giời	g i ờ i |
mạy	m ạ y |
đũi	đ ũ i |
găn	g ă n |
okay	o k a y |
dủi	d ủ i |
open	o p e n |
tro	t r o |
hạng	h ạ n g |
ampli	a m p l i |
thòa	t h ò a |
bobin	b o b i n |
măng	m ă n g |
bộc	b ộ c |
cọc	c ọ c |
thìa	t h ì a |
xệch	x ệ c h |
đú	đ ú |
mụn	m ụ n |
vợi	v ợ i |
thổ	t h ổ |
gram	g r a m |
xoá	x o á |
cam	c a m |
khủ	k h ủ |
thỏ	t h ỏ |
ví	v í |
ngọm	n g ọ m |
polymer	p o l y m e r |
khẩy	k h ẩ y |
sếp	s ế p |
dõng	d õ n g |
tán	t á n |
ngẫn	n g ẫ n |
ghé	g h é |
nâng	n â n g |
zuoih	z u o i h |
hằn	h ằ n |
diu	d i u |
tay	t a y |
choàm	c h o à m |
cty	c t y |
hắt	h ắ t |
đạng	đ ạ n g |
guồng	g u ồ n g |
cảnh	c ả n h |
lấn	l ấ n |
bằm	b ằ m |
mự	m ự |
đụng	đ ụ n g |
fe	f e |
nhường	n h ư ờ n g |
phui	p h u i |
bạp	b ạ p |
hin	h i n |
phổi	p h ổ i |
po	p o |
ruy	r u y |
xang	x a n g |
pót	p ó t |
trôm	t r ô m |
hà	h à |
credit	c r e d i t |
sủng	s ủ n g |
sta	s t a |
byte	b y t e |
béng	b é n g |
đành	đ à n h |
gịt	g ị t |
phu	p h u |
chính	c h í n h |
mộngtriệu	m ộ n g t r i ệ u |
helium	h e l i u m |
xèng	x è n g |
đứng	đ ứ n g |
trệ	t r ệ |
ngọng	n g ọ n g |
mủm	m ủ m |
rật	r ậ t |
rảo	r ả o |
vế	v ế |
khệnh	k h ệ n h |
trun	t r u n |
bưởi	b ư ở i |
bặp	b ặ p |
túng	t ú n g |
cheo	c h e o |
sớn	s ớ n |
nẫm	n ẫ m |
biêng	b i ê n g |
xọ	x ọ |
mầu	m ầ u |
thững	t h ữ n g |
massage	m a s s a g e |
khiêu	k h i ê u |
newton	n e w t o n |
vét	v é t |
toè	t o è |
tượt	t ư ợ t |
hềnh	h ề n h |
macketinh	m a c k e t i n h |
ballad	b a l l a d |
nguyễn	n g u y ễ n |
toèn	t o è n |
sành	s à n h |
tưng	t ư n g |
thuở	t h u ở |
golf	g o l f |
quàu	q u à u |
um	u m |
bõng	b õ n g |
sụn	s ụ n |
sánh	s á n h |
jăm	j ă m |
xỉa	x ỉ a |
cộn	c ộ n |
vùn	v ù n |
uở	u ở |
trờn	t r ờ n |
microfiche	m i c r o f i c h e |
lổn	l ổ n |
lúng	l ú n g |
giòng	g i ò n g |
đáu	đ á u |
giãn	g i ã n |
rụt	r ụ t |
bai	b a i |
my	m y |
thóc	t h ó c |
ngúng	n g ú n g |
quan	q u a n |
gigabit	g i g a b i t |
thề	t h ề |
vỡ	v ỡ |
sòi	s ò i |
chéng	c h é n g |
hg	h g |
đexi	đ e x i |
ướm	ư ớ m |
đin	đ i n |
bậm	b ậ m |
xoàng	x o à n g |
ồm	ồ m |
bồng	b ồ n g |
coi	c o i |
truật	t r u ậ t |
đôminô	đ ô m i n ô |
lù	l ù |
chè	c h è |
cầm	c ầ m |
tẩu	t ẩ u |
khễnh	k h ễ n h |
nhớt	n h ớ t |
upload	u p l o a d |
xong	x o n g |
lục	l ụ c |
sảy	s ả y |
gọc	g ọ c |
hạo	h ạ o |
hõm	h õ m |
võnc	v õ n c |
phia	p h i a |
chùng	c h ù n g |
tho	t h o |
cn	c n |
xtăng	x t ă n g |
lủ	l ủ |
tỏi	t ỏ i |
điền	đ i ề n |
loá	l o á |
hẳm	h ẳ m |
triod	t r i o d |
lom	l o m |
thai	t h a i |
nghện	n g h ệ n |
thua	t h u a |
khạc	k h ạ c |
micro	m i c r o |
tễnh	t ễ n h |
xoải	x o ả i |
ampere	a m p e r e |
phào	p h à o |
khác	k h á c |
vẹc	v ẹ c |
chơi	c h ơ i |
chức	c h ứ c |
snách	s n á c h |
zeolit	z e o l i t |
phi	p h i |
cháu	c h á u |
ngao	n g a o |
kíu	k í u |
gông	g ô n g |
thun	t h u n |
điu	đ i u |
lời	l ờ i |
phếch	p h ế c h |
kaolin	k a o l i n |
brô	b r ô |
tiếc	t i ế c |
pe	p e |
xpen	x p e n |
đờ	đ ờ |
khều	k h ề u |
thạp	t h ạ p |
foxep	f o x e p |
gặt	g ặ t |
goòng	g o ò n g |
toẻ	t o ẻ |
bờn	b ờ n |
tiê	t i ê |
té	t é |
tỵ	t ỵ |
kẹp	k ẹ p |
tuồn	t u ồ n |
nhặn	n h ặ n |
đuễnh	đ u ễ n h |
quéc	q u é c |
cuồng	c u ồ n g |
mâng	m â n g |
chổm	c h ổ m |
tồng	t ồ n g |
chặm	c h ặ m |
nhột	n h ộ t |
đái	đ á i |
ghép	g h é p |
dã	d ã |
nhê	n h ê |
ay	a y |
lúy	l ú y |
sêếu	s ê ế u |
bóp	b ó p |
thiếu	t h i ế u |
ạở	ạ ở |
teng	t e n g |
phẹc	p h ẹ c |
thạc	t h ạ c |
mặt	m ặ t |
lặc	l ặ c |
maser	m a s e r |
dìm	d ì m |
than	t h a n |
lu	l u |
ơn	ơ n |
antimony	a n t i m o n y |
queen	q u e e n |
crôm	c r ô m |
dết	d ế t |
hơng	h ơ n g |
thối	t h ố i |
hạy	h ạ y |
rức	r ứ c |
choài	c h o à i |
nhè	n h è |
phịch	p h ị c h |
mừng	m ừ n g |
ngàn	n g à n |
thoảng	t h o ả n g |
thíp	t h í p |
nghễ	n g h ễ |
đỉ	đ ỉ |
ae	a e |
xu	x u |
đọn	đ ọ n |
phe	p h e |
ây	â y |
móc	m ó c |
ph	p h |
chì	c h ì |
mắn	m ắ n |
xônat	x ô n a t |
hđqt	h đ q t |
dằm	d ằ m |
miếu	m i ế u |
trà	t r à |
penicillin	p e n i c i l l i n |
vịnh	v ị n h |
naira	n a i r a |
chiêng	c h i ê n g |
cave	c a v e |
dầy	d ầ y |
khí	k h í |
vila	v i l a |
sựt	s ự t |
uể	u ể |
thệ	t h ệ |
ngoăng	n g o ă n g |
cấn	c ấ n |
nậy	n ậ y |
ngía	n g í a |
dét	d é t |
têu	t ê u |
bíu	b í u |
gio	g i o |
sôcôla	s ô c ô l a |
đun	đ u n |
ngốc	n g ố c |
bọn	b ọ n |
dướỉ	d ư ớ ỉ |
khâu	k h â u |
phinh	p h i n h |
tuy	t u y |
quạc	q u ạ c |
hoắng	h o ắ n g |
khểnh	k h ể n h |
rách	r á c h |
ngủng	n g ủ n g |
gièm	g i è m |
chắt	c h ắ t |
chồn	c h ồ n |
sục	s ụ c |
nhíu	n h í u |
bển	b ể n |
lốc	l ố c |
dynamo	d y n a m o |
sứt	s ứ t |
silicone	s i l i c o n e |
ngay	n g a y |
tiêm	t i ê m |
ngắc	n g ắ c |
malanh	m a l a n h |
herb	h e r b |
dừ	d ừ |
tin	t i n |
nơm	n ơ m |
vitcô	v i t c ô |
quark	q u a r k |
đỏm	đ ỏ m |
ngúc	n g ú c |
cabin	c a b i n |
sulfamide	s u l f a m i d e |
gùa	g ù a |
xeo	x e o |
riệt	r i ệ t |
quái	q u á i |
gẫy	g ẫ y |
bờm	b ờ m |
giẹp	g i ẹ p |
lẳm	l ẳ m |
chõm	c h õ m |
nhỏn	n h ỏ n |
hoăc	h o ă c |
tháy	t h á y |
nách	n á c h |
hooligan	h o o l i g a n |
bẳn	b ẳ n |
mỵ	m ỵ |
quản	q u ả n |
kaki	k a k i |
kiến	k i ế n |
cẩn	c ẩ n |
hẻ	h ẻ |
garden	g a r d e n |
chôn	c h ô n |
lèn	l è n |
vảng	v ả n g |
rưới	r ư ớ i |
ubuntu	u b u n t u |
hầu	h ầ u |
rạn	r ạ n |
vâm	v â m |
dưới	d ư ớ i |
duềnh	d u ề n h |
mết	m ế t |
nhiêu	n h i ê u |
tặng	t ặ n g |
gằn	g ằ n |
ngáo	n g á o |
nilông	n i l ô n g |
gọn	g ọ n |
phường	p h ư ờ n g |
ắt	ắ t |
electronvôn	e l e c t r o n v ô n |
đồn	đ ồ n |
bửu	b ử u |
tèn	t è n |
trợi	t r ợ i |
hindu	h i n d u |
ngơn	n g ơ n |
trắm	t r ắ m |
nã	n ã |
cê	c ê |
nhời	n h ờ i |
nhẻm	n h ẻ m |
bct	b c t |
ngăn	n g ă n |
băngca	b ă n g c a |
ngầm	n g ầ m |
bum	b u m |
halloween	h a l l o w e e n |
manheto	m a n h e t o |
gièy	g i è y |
goét	g o é t |
khướt	k h ư ớ t |
toạc	t o ạ c |
viên	v i ê n |
ray	r a y |
catwalk	c a t w a l k |
xún	x ú n |
quề	q u ề |
vếu	v ế u |
búi	b ú i |
latti	l a t t i |
lứa	l ứ a |
sunfamit	s u n f a m i t |
zốt	z ố t |
breaker	b r e a k e r |
diê	d i ê |
giạng	g i ạ n g |
lầy	l ầ y |
enzyme	e n z y m e |
tườm	t ư ờ m |
thờm	t h ờ m |
kiểu	k i ể u |
fua	f u a |
xủng	x ủ n g |
preh	p r e h |
dặt	d ặ t |
ngẩu	n g ẩ u |
magie	m a g i e |
xàu	x à u |
rẫm	r ẫ m |
fin	f i n |
rơi	r ơ i |
mợ	m ợ |
uẩy	u ẩ y |
gái	g á i |
xầm	x ầ m |
khuơ	k h u ơ |
sôi	s ô i |
vựng	v ự n g |
toong	t o o n g |
quỉ	q u ỉ |
nám	n á m |
trụt	t r ụ t |
thép	t h é p |
khứ	k h ứ |
đè	đ è |
loan	l o a n |
niễng	n i ễ n g |
trắc	t r ắ c |
trích	t r í c h |
dọp	d ọ p |
quài	q u à i |
suởi	s u ở i |
chừ	c h ừ |
irc	i r c |
mèn	m è n |
rần	r ầ n |
javen	j a v e n |
vình	v ì n h |
mảnh	m ả n h |
trừ	t r ừ |
drăm	d r ă m |
sấu	s ấ u |
xphan	x p h a n |
diod	d i o d |
phỡn	p h ỡ n |
đấu	đ ấ u |
thùn	t h ù n |
phốp	p h ố p |
chuộng	c h u ộ n g |
khô	k h ô |
tháng	t h á n g |
gợi	g ợ i |
khoẻo	k h o ẻ o |
khỏ	k h ỏ |
cột	c ộ t |
box	b o x |
vá	v á |
rởm	r ở m |
thì	t h ì |
chệ	c h ệ |
nệ	n ệ |
viê	v i ê |
hmu	h m u |
lủn	l ủ n |
hững	h ữ n g |
dán	d á n |
oẳn	o ẳ n |
ổng	ổ n g |
trùi	t r ù i |
trạc	t r ạ c |
cacbonic	c a c b o n i c |
yếm	y ế m |
rẻ	r ẻ |
đượi	đ ư ợ i |
soupape	s o u p a p e |
ôtô	ô t ô |
kệ	k ệ |
toanh	t o a n h |
tỏ	t ỏ |
sênh	s ê n h |
hỗ	h ỗ |
gởi	g ở i |
nt	n t |
bẹo	b ẹ o |
nhượng	n h ư ợ n g |
én	é n |
xuôi	x u ô i |
sớm	s ớ m |
hoắc	h o ắ c |
ethylen	e t h y l e n |
suỵt	s u ỵ t |
ngắm	n g ắ m |
xenon	x e n o n |
commando	c o m m a n d o |
bệp	b ệ p |
ưng	ư n g |
hâu	h â u |
sướt	s ư ớ t |
bụng	b ụ n g |
hoạch	h o ạ c h |
xoạch	x o ạ c h |
đtđl	đ t đ l |
ngìn	n g ì n |
mươì	m ư ơ ì |
độn	đ ộ n |
mắc	m ắ c |
tởn	t ở n |
bhyt	b h y t |
thườn	t h ư ờ n |
cóc	c ó c |
xịu	x ị u |
sim	s i m |
đước	đ ư ớ c |
voice	v o i c e |
sào	s à o |
êkip	ê k i p |
tọt	t ọ t |
scaner	s c a n e r |
quinin	q u i n i n |
đẫm	đ ẫ m |
phòng	p h ò n g |
lãn	l ã n |
bismuth	b i s m u t h |
gang	g a n g |
hạnh	h ạ n h |
ghểnh	g h ể n h |
cật	c ậ t |
giămbông	g i ă m b ô n g |
dây	d â y |
nỡm	n ỡ m |
đượm	đ ư ợ m |
ngoạy	n g o ạ y |
tetracycline	t e t r a c y c l i n e |
bun	b u n |
trõn	t r õ n |
dơ	d ơ |
chẻo	c h ẻ o |
độ	đ ộ |
thả	t h ả |
dynamit	d y n a m i t |
xoàn	x o à n |
khuây	k h u â y |
rươi	r ư ơ i |
nhoé	n h o é |
phách	p h á c h |
rúng	r ú n g |
trủng	t r ủ n g |
điot	đ i o t |
xòe	x ò e |
h	h |
biogas	b i o g a s |
lụp	l ụ p |
vấu	v ấ u |
sửng	s ử n g |
phùn	p h ù n |
dạn	d ạ n |
chễm	c h ễ m |
kể	k ể |
môngtagiơ	m ô n g t a g i ơ |
tỏa	t ỏ a |
thến	t h ế n |
loti	l o t i |
parabol	p a r a b o l |
xiến	x i ế n |
hiệp	h i ệ p |
chía	c h í a |
gấy	g ấ y |
neo	n e o |
đôn	đ ô n |
chím	c h í m |
đũa	đ ũ a |
kva	k v a |
codein	c o d e i n |
boóc	b o ó c |
ràng	r à n g |
dôi	d ô i |
gamma	g a m m a |
garô	g a r ô |
tén	t é n |
trốt	t r ố t |
bổng	b ổ n g |
tạo	t ạ o |
cello	c e l l o |
bờ	b ờ |
thải	t h ả i |
trong	t r o n g |
sỉnh	s ỉ n h |
gừng	g ừ n g |
gàu	g à u |
đẩy	đ ẩ y |
choại	c h o ạ i |
choai	c h o a i |
óc	ó c |
dĩnh	d ĩ n h |
giải	g i ả i |
linux	l i n u x |
ry	r y |
khủa	k h ủ a |
trập	t r ậ p |
nhăng	n h ă n g |
lựu	l ự u |
trả	t r ả |
tản	t ả n |
càm	c à m |
xoà	x o à |
xéo	x é o |
sằng	s ằ n g |
bấp	b ấ p |
rupee	r u p e e |
riđô	r i đ ô |
rúc	r ú c |
khênh	k h ê n h |
uy	u y |
găp	g ă p |
khứu	k h ứ u |
fob	f o b |
nỗi	n ỗ i |
hypebol	h y p e b o l |
vời	v ờ i |
sịp	s ị p |
tiễn	t i ễ n |
ỉm	ỉ m |
vernis	v e r n i s |
viễn	v i ễ n |
dạ	d ạ |
đạm	đ ạ m |
nhím	n h í m |
diễu	d i ễ u |
rubi	r u b i |
từng	t ừ n g |
đến	đ ế n |
knia	k n i a |
nuốc	n u ố c |
nọng	n ọ n g |
vù	v ù |
nganh	n g a n h |
nộn	n ộ n |
ngẫu	n g ẫ u |
thuẫn	t h u ẫ n |
sắc	s ắ c |
quảng	q u ả n g |
cám	c á m |
xênh	x ê n h |
suýt	s u ý t |
benzen	b e n z e n |
kip	k i p |
hiếu	h i ế u |
bổ	b ổ |
br	b r |
dộng	d ộ n g |
cai	c a i |
calib	c a l i b |
tưa	t ư a |
đếch	đ ế c h |
ré	r é |
sang	s a n g |
xá	x á |
cạp	c ạ p |
rộng	r ộ n g |
bự	b ự |
ngờm	n g ờ m |
rẩy	r ẩ y |
lộp	l ộ p |
stop	s t o p |
dút	d ú t |
đoá	đ o á |
mục	m ụ c |
buồng	b u ồ n g |
tlát	t l á t |
gợn	g ợ n |
ancaloit	a n c a l o i t |
cla	c l a |
ngạch	n g ạ c h |
tới	t ớ i |
nhếch	n h ế c h |
giả	g i ả |
miẻo	m i ẻ o |
num	n u m |
dỏng	d ỏ n g |
thưỡn	t h ư ỡ n |
mangan	m a n g a n |
trớp	t r ớ p |
xồng	x ồ n g |
hốc	h ố c |
sx	s x |
vua	v u a |
oe	o e |
lưỡỉ	l ư ỡ ỉ |
sida	s i d a |
ngôi	n g ô i |
mỏi	m ỏ i |
trừng	t r ừ n g |
ủng	ủ n g |
nào	n à o |
rợn	r ợ n |
nino	n i n o |
vồng	v ồ n g |
khín	k h í n |
zan	z a n |
lịch	l ị c h |
thiền	t h i ề n |
ngẵng	n g ẵ n g |
emetin	e m e t i n |
toạng	t o ạ n g |
cúc	c ú c |
ế	ế |
dứt	d ứ t |
món	m ó n |
hữ	h ữ |
thấm	t h ấ m |
sunfua	s u n f u a |
ngách	n g á c h |
dám	d á m |
mản	m ả n |
bị	b ị |
hoè	h o è |
nhỏm	n h ỏ m |
col	c o l |
mùn	m ù n |
ballast	b a l l a s t |
vecni	v e c n i |
xenlô	x e n l ô |
asen	a s e n |
lẩu	l ẩ u |
atropin	a t r o p i n |
ụ	ụ |
dy	d y |
nhưng	n h ư n g |
ùn	ù n |
tiệc	t i ệ c |
tầy	t ầ y |
ngoạp	n g o ạ p |
trầu	t r ầ u |
dơn	d ơ n |
chuệnh	c h u ệ n h |
dịt	d ị t |
nghiên	n g h i ê n |
giảu	g i ả u |
ngoáp	n g o á p |
kiếng	k i ế n g |
it	i t |
vietin	v i e t i n |
míu	m í u |
soát	s o á t |
lói	l ó i |
geneva	g e n e v a |
viêm	v i ê m |
giau	g i a u |
http	h t t p |
bôi	b ô i |
acmonica	a c m o n i c a |
nuộc	n u ộ c |
zn	z n |
hói	h ó i |
mường	m ư ờ n g |
chúa	c h ú a |
xpi	x p i |
nỏm	n ỏ m |
derô	d e r ô |
ngoay	n g o a y |
nớ	n ớ |
thiềng	t h i ề n g |
gíp	g í p |
thói	t h ó i |
vậm	v ậ m |
suất	s u ấ t |
xùm	x ù m |
trá	t r á |
gala	g a l a |
giâu	g i â u |
lốm	l ố m |
kèo	k è o |
sậm	s ậ m |
tuồi	t u ồ i |
rỡ	r ỡ |
tòng	t ò n g |
luỹ	l u ỹ |
tts	t t s |
chinh	c h i n h |
lư	l ư |
nhẹ	n h ẹ |
êning	ê n i n g |
javel	j a v e l |
côm	c ô m |
al	a l |
thuột	t h u ộ t |
guổng	g u ổ n g |
tiu	t i u |
viện	v i ệ n |
phẳng	p h ẳ n g |
gát	g á t |
đoái	đ o á i |
an	a n |
giốt	g i ố t |
nitơ	n i t ơ |
kiêu	k i ê u |
bệt	b ệ t |
tựa	t ự a |
lade	l a d e |
khoan	k h o a n |
trốn	t r ố n |
nghệch	n g h ệ c h |
chầu	c h ầ u |
rượt	r ư ợ t |
cắng	c ắ n g |
scn	s c n |
sn	s n |
afrikaans	a f r i k a a n s |
bớp	b ớ p |
thâ	t h â |
mỹ	m ỹ |
cụm	c ụ m |
táy	t á y |
dirham	d i r h a m |
gọt	g ọ t |
sò	s ò |
silica	s i l i c a |
chồ	c h ồ |
cước	c ư ớ c |
thư	t h ư |
ăm	ă m |
poa	p o a |
rương	r ư ơ n g |
tầm	t ầ m |
cắt	c ắ t |
hờm	h ờ m |
pêđê	p ê đ ê |
kẻng	k ẻ n g |
phịu	p h ị u |
vụt	v ụ t |
lạo	l ạ o |
hình	h ì n h |
guarani	g u a r a n i |
thy	t h y |
luu	l u u |
bạn	b ạ n |
toan	t o a n |
đuổi	đ u ổ i |
kha	k h a |
hừ	h ừ |
sulfamid	s u l f a m i d |
mề	m ề |
hiếng	h i ế n g |
trễ	t r ễ |
quĩ	q u ĩ |
samovar	s a m o v a r |
orăng	o r ă n g |
dừa	d ừ a |
hàng	h à n g |
wiktionary	w i k t i o n a r y |
bupphê	b u p p h ê |
òi	ò i |
tềnh	t ề n h |
dượng	d ư ợ n g |
đáo	đ á o |
xắt	x ắ t |
trề	t r ề |
phũng	p h ũ n g |
niño	n i n o |
tia	t i a |
biêu	b i ê u |
sủ	s ủ |
r	r |
suồng	s u ồ n g |
chủng	c h ủ n g |
gotic	g o t i c |
thừi	t h ừ i |
liều	l i ề u |
ái	á i |
nguýt	n g u ý t |
nguệch	n g u ệ c h |
hollywood	h o l l y w o o d |
cút	c ú t |
dên	d ê n |
ệp	ệ p |
phài	p h à i |
nậng	n ậ n g |
cợm	c ợ m |
tại	t ạ i |
modern	m o d e r n |
kễnh	k ễ n h |
giền	g i ề n |
maníp	m a n í p |
ngúm	n g ú m |
kờ	k ờ |
chêu	c h ê u |
chem	c h e m |
ngươí	n g ư ơ í |
quả	q u ả |
láng	l á n g |
laptop	l a p t o p |
vcd	v c d |
nạo	n ạ o |
quyện	q u y ệ n |
nhịu	n h ị u |
ganh	g a n h |
quới	q u ớ i |
logic	l o g i c |
nickel	n i c k e l |
quắp	q u ắ p |
chánh	c h á n h |
xị	x ị |
phễu	p h ễ u |
nhum	n h u m |
võng	v õ n g |
xòa	x ò a |
thày	t h à y |
sũng	s ũ n g |
hroi	h r o i |
khoản	k h o ả n |
hôn	h ô n |
ngủn	n g ủ n |
ọ	ọ |
còn	c ò n |
bèm	b è m |
gùn	g ù n |
cang	c a n g |
phen	p h e n |
thôể	t h ô ể |
nitrat	n i t r a t |
thười	t h ư ờ i |
stato	s t a t o |
cheng	c h e n g |
photon	p h o t o n |
đau	đ a u |
vẻn	v ẻ n |
lườm	l ư ờ m |
cos	c o s |
khậc	k h ậ c |
ung	u n g |
chường	c h ư ờ n g |
dằn	d ằ n |
rẻo	r ẻ o |
xanhđica	x a n h đ i c a |
nạp	n ạ p |
ctcp	c t c p |
chã	c h ã |
kích	k í c h |
ảng	ả n g |
chĩnh	c h ĩ n h |
hớm	h ớ m |
cuỗm	c u ỗ m |
mia	m i a |
asphalt	a s p h a l t |
hểu	h ể u |
bót	b ó t |
nhoai	n h o a i |
nhiễm	n h i ễ m |
gụt	g ụ t |
khuỷnh	k h u ỷ n h |
ngứng	n g ứ n g |
chí	c h í |
thốt	t h ố t |
kem	k e m |
khịu	k h ị u |
de	d e |
hoc	h o c |
cortison	c o r t i s o n |
quyn	q u y n |
asean	a s e a n |
nhìu	n h ì u |
trảy	t r ả y |
hách	h á c h |
kpă	k p ă |
bạc	b ạ c |
dát	d á t |
polivitamin	p o l i v i t a m i n |
tuỳ	t u ỳ |
xẹ	x ẹ |
nhơ	n h ơ |
đẹp	đ ẹ p |
ỏc	ỏ c |
trust	t r u s t |
rạ	r ạ |
goép	g o é p |
rổn	r ổ n |
đả	đ ả |
zen	z e n |
kinin	k i n i n |
tô	t ô |
nhảy	n h ả y |
biển	b i ể n |
nới	n ớ i |
nitrogen	n i t r o g e n |
khoang	k h o a n g |
oxid	o x i d |
ngợp	n g ợ p |
đào	đ à o |
hới	h ớ i |
giạp	g i ạ p |
dềnh	d ề n h |
bịp	b ị p |
nao	n a o |
trại	t r ạ i |
pt	p t |
xẩn	x ẩ n |
thòng	t h ò n g |
xíu	x í u |
chảng	c h ả n g |
vặc	v ặ c |
boóng	b o ó n g |
khoa	k h o a |
niken	n i k e n |
chăng	c h ă n g |
nớt	n ớ t |
kí	k í |
tủn	t ủ n |
nhộng	n h ộ n g |
giồi	g i ồ i |
annam	a n n a m |
quàng	q u à n g |
mẩm	m ẩ m |
diệc	d i ệ c |
choang	c h o a n g |
ranh	r a n h |
nguỷu	n g u ỷ u |
nhẩy	n h ẩ y |
wi	w i |
clarinet	c l a r i n e t |
quớ	q u ớ |
ngột	n g ộ t |
trờm	t r ờ m |
anbum	a n b u m |
củng	c ủ n g |
vây	v â y |
vóc	v ó c |
táu	t á u |
giàm	g i à m |
sẹt	s ẹ t |
sụ	s ụ |
tĩu	t ĩ u |
mọt	m ọ t |
lđvp	l đ v p |
phều	p h ề u |
nhục	n h ụ c |
đưỡn	đ ư ỡ n |
attomat	a t t o m a t |
phên	p h ê n |
dời	d ờ i |
chàm	c h à m |
carbin	c a r b i n |
trộm	t r ộ m |
g	g |
vai	v a i |
phanh	p h a n h |
mánh	m á n h |
bợt	b ợ t |
tỉ	t ỉ |
ghét	g h é t |
phùa	p h ù a |
nốp	n ố p |
trảo	t r ả o |
cra	c r a |
xỉu	x ỉ u |
leninit	l e n i n i t |
hẳng	h ẳ n g |
tuất	t u ấ t |
nổng	n ổ n g |
mụp	m ụ p |
léc	l é c |
chệnh	c h ệ n h |
dịp	d ị p |
đơm	đ ơ m |
phía	p h í a |
cổn	c ổ n |
boongke	b o o n g k e |
đẩu	đ ẩ u |
gánh	g á n h |
thuơng	t h u ơ n g |
ghim	g h i m |
trác	t r á c |
lâm	l â m |
rỉnh	r ỉ n h |
khét	k h é t |
toảng	t o ả n g |
ngài	n g à i |
êtô	ê t ô |
kót	k ó t |
underdrawer	u n d e r d r a w e r |
mà	m à |
sưòn	s ư ò n |
nâu	n â u |
chuỳ	c h u ỳ |
xn	x n |
đất	đ ấ t |
siết	s i ế t |
đoãng	đ o ã n g |
xởi	x ở i |
bù	b ù |
lảng	l ả n g |
bễ	b ễ |
choãi	c h o ã i |
hăm	h ă m |
ởnguyễn	ở n g u y ễ n |
dơi	d ơ i |
chống	c h ố n g |
ngực	n g ự c |
lách	l á c h |
đặt	đ ặ t |
quăn	q u ă n |
mantoza	m a n t o z a |
choòng	c h o ò n g |
trạt	t r ạ t |
khuếch	k h u ế c h |
khoả	k h o ả |
luyện	l u y ệ n |
lẵng	l ẵ n g |
tabu	t a b u |
taschenlampe	t a s c h e n l a m p e |
khoanh	k h o a n h |
tuabin	t u a b i n |
min	m i n |
đuống	đ u ố n g |
màn	m à n |
thọt	t h ọ t |
acetylene	a c e t y l e n e |
xềnh	x ề n h |
tặn	t ặ n |
lẹp	l ẹ p |
acbit	a c b i t |
xót	x ó t |
lụm	l ụ m |
sion	s i o n |
toang	t o a n g |
gr	g r |
go	g o |
mịnh	m ị n h |
rượng	r ư ợ n g |
phẫu	p h ẫ u |
delta	d e l t a |
huyền	h u y ề n |
hawaii	h a w a i i |
seminar	s e m i n a r |
thị	t h ị |
grát	g r á t |
puốc	p u ố c |
phít	p h í t |
nết	n ế t |
chấp	c h ấ p |
lượng	l ư ợ n g |
chảm	c h ả m |
dễ	d ễ |
rước	r ư ớ c |
ời	ờ i |
rấp	r ấ p |
ruộm	r u ộ m |
zero	z e r o |
priori	p r i o r i |
thuội	t h u ộ i |
khiền	k h i ề n |
đrin	đ r i n |
thiểm	t h i ể m |
balat	b a l a t |
vặn	v ặ n |
phàm	p h à m |
bỉ	b ỉ |
giáng	g i á n g |
nình	n ì n h |
xã	x ã |
daj	d a j |
hự	h ự |
mớ	m ớ |
rích	r í c h |
stt	s t t |
thúng	t h ú n g |
ghễnh	g h ễ n h |
plê	p l ê |
nhom	n h o m |
goi	g o i |
ngõ	n g õ |
fét	f é t |
phễn	p h ễ n |
bén	b é n |
ammoniac	a m m o n i a c |
hecta	h e c t a |
ngông	n g ô n g |
cấm	c ấ m |
kháo	k h á o |
buy	b u y |
hích	h í c h |
rím	r í m |
chồng	c h ồ n g |
giăm	g i ă m |
mịn	m ị n |
ngoái	n g o á i |
phông	p h ô n g |
cãi	c ã i |
choạng	c h o ạ n g |
khuông	k h u ô n g |
hđrung	h đ r u n g |
taj	t a j |
morphine	m o r p h i n e |
hèn	h è n |
hổ	h ổ |
bụt	b ụ t |
múp	m ú p |
lui	l u i |
cạo	c ạ o |
khảng	k h ả n g |
contrabass	c o n t r a b a s s |
giạt	g i ạ t |
rạt	r ạ t |
tr	t r |
sulfur	s u l f u r |
yếu	y ế u |
điệnlực	đ i ệ n l ự c |
sồm	s ồ m |
doạng	d o ạ n g |
hĩ	h ĩ |
dõ	d õ |
tóe	t ó e |
giỗ	g i ỗ |
heli	h e l i |
dẩu	d ẩ u |
luột	l u ộ t |
iêu	i ê u |
vp	v p |
khoông	k h o ô n g |
ờtại	ờ t ạ i |
doãi	d o ã i |
đủi	đ ủ i |
phải	p h ả i |
khoe	k h o e |
matxa	m a t x a |
sam	s a m |
giận	g i ậ n |
trảm	t r ả m |
phá	p h á |
ành	à n h |
nhùng	n h ù n g |
tằng	t ằ n g |
giắng	g i ắ n g |
diệt	d i ệ t |
xốp	x ố p |
uống	u ố n g |
bư	b ư |
đột	đ ộ t |
rôngđen	r ô n g đ e n |
lợi	l ợ i |
túc	t ú c |
loả	l o ả |
xế	x ế |
doạ	d o ạ |
robot	r o b o t |
ó	ó |
mt	m t |
vãn	v ã n |
chẽn	c h ẽ n |
mìn	m ì n |
khuôn	k h u ô n |
câ	c â |
sunfat	s u n f a t |
cy	c y |
lilangeni	l i l a n g e n i |
ếch	ế c h |
nợp	n ợ p |
tị	t ị |
nhoèn	n h o è n |
giú	g i ú |
media	m e d i a |
enzim	e n z i m |
cụi	c ụ i |
tịch	t ị c h |
đoảng	đ o ả n g |
kịp	k ị p |
khệ	k h ệ |
hảm	h ả m |
nũi	n ũ i |
sổ	s ổ |
nênh	n ê n h |
cuốn	c u ố n |
hắc	h ắ c |
mù	m ù |
bụa	b ụ a |
lự	l ự |
trậm	t r ậ m |
sẹ	s ẹ |
ct	c t |
tiêng	t i ê n g |
glucose	g l u c o s e |
lăm	l ă m |
glucide	g l u c i d e |
túp	t ú p |
gồm	g ồ m |
phòi	p h ò i |
phủi	p h ủ i |
khạ	k h ạ |
nhắc	n h ắ c |
mui	m u i |
chầm	c h ầ m |
cưởi	c ư ở i |
vòi	v ò i |
chiếu	c h i ế u |
bồn	b ồ n |
mẫu	m ẫ u |
chử	c h ử |
nhun	n h u n |
gư	g ư |
lồng	l ồ n g |
cóng	c ó n g |
gằm	g ằ m |
bứ	b ứ |
xuýt	x u ý t |
khiếp	k h i ế p |
nghìn	n g h ì n |
tron	t r o n |
dụm	d ụ m |
xú	x ú |
qlvh	q l v h |
kháu	k h á u |
ợt	ợ t |
hoan	h o a n |
khưởng	k h ư ở n g |
vưu	v ư u |
hoạn	h o ạ n |
rơmooc	r ơ m o o c |
tăngbo	t ă n g b o |
trẩn	t r ẩ n |
phẩm	p h ẩ m |
hệch	h ệ c h |
tuynen	t u y n e n |
đợ	đ ợ |
vat	v a t |
ngẩm	n g ẩ m |
củi	c ủ i |
nả	n ả |
gành	g à n h |
phay	p h a y |
quạo	q u ạ o |
mậm	m ậ m |
lóc	l ó c |
cướng	c ư ớ n g |
phức	p h ứ c |
giụa	g i ụ a |
tràng	t r à n g |
giầy	g i ầ y |
khuyết	k h u y ế t |
khề	k h ề |
su	s u |
trọn	t r ọ n |
róa	r ó a |
sê	s ê |
ning	n i n g |
ngẹt	n g ẹ t |
trĩu	t r ĩ u |
nhoạng	n h o ạ n g |
canon	c a n o n |
chốt	c h ố t |
dái	d á i |
chò	c h ò |
ngầy	n g ầ y |
suyển	s u y ể n |
gấn	g ấ n |
thuy	t h u y |
choá	c h o á |
bẫy	b ẫ y |
xâu	x â u |
khù	k h ù |
khà	k h à |
òy	ò y |
cày	c à y |
chiểu	c h i ể u |
châng	c h â n g |
chiến	c h i ế n |
méo	m é o |
xỏa	x ỏ a |
điếc	đ i ế c |
tít	t í t |
rập	r ậ p |
trâm	t r â m |
contac	c o n t a c |
điềng	đ i ề n g |
ghít	g h í t |
hoắm	h o ắ m |
thi	t h i |
lọng	l ọ n g |
rônêô	r ô n ê ô |
dĩ	d ĩ |
bướm	b ư ớ m |
tợn	t ợ n |
nhọc	n h ọ c |
thhủ	t h h ủ |
amip	a m i p |
yểng	y ể n g |
oxide	o x i d e |
nhệu	n h ệ u |
ỏn	ỏ n |
aà	a à |
gáu	g á u |
muối	m u ố i |
đây	đ â y |
xẵng	x ẵ n g |
pun	p u n |
đuyra	đ u y r a |
tha	t h a |
thở	t h ở |
hài	h à i |
khíu	k h í u |
vẹm	v ẹ m |
cotang	c o t a n g |
trầy	t r ầ y |
chòe	c h ò e |
mỡ	m ỡ |
ngh	n g h |
thạo	t h ạ o |
tùng	t ù n g |
rằm	r ằ m |
bỏm	b ỏ m |
saccharos	s a c c h a r o s |
xúi	x ú i |
phon	p h o n |
hoi	h o i |
tiều	t i ề u |
trỏng	t r ỏ n g |
riêng	r i ê n g |
kuynh	k u y n h |
phết	p h ế t |
tậm	t ậ m |
eto	e t o |
rướn	r ư ớ n |
ủn	ủ n |
vũm	v ũ m |
dợi	d ợ i |
deo	d e o |
tràn	t r à n |
đí	đ í |
mủ	m ủ |
choăn	c h o ă n |
nhách	n h á c h |
đựng	đ ự n g |
jắc	j ắ c |
bok	b o k |
bê	b ê |
lép	l é p |
tỳ	t ỳ |
log	l o g |
lua	l u a |
ghề	g h ề |
ayun	a y u n |
tì	t ì |
nhẹn	n h ẹ n |
glycerine	g l y c e r i n e |
mành	m à n h |
tiễu	t i ễ u |
chặng	c h ặ n g |
tuỷ	t u ỷ |
nhã	n h ã |
hấng	h ấ n g |
soạt	s o ạ t |
miều	m i ề u |
phiên	p h i ê n |
chiếp	c h i ế p |
khoắn	k h o ắ n |
xiềng	x i ề n g |
bủm	b ủ m |
trinh	t r i n h |
tào	t à o |
quýu	q u ý u |
mọc	m ọ c |
volfram	v o l f r a m |
lè	l è |
nghem	n g h e m |
bế	b ế |
bàn	b à n |
tèo	t è o |
nồng	n ồ n g |
trám	t r á m |
tuý	t u ý |
carate	c a r a t e |
lôgic	l ô g i c |
siêm	s i ê m |
bom	b o m |
hòng	h ò n g |
nũng	n ũ n g |
litô	l i t ô |
xẩm	x ẩ m |
đươ	đ ư ơ |
hức	h ứ c |
nấng	n ấ n g |
nat	n a t |
chớm	c h ớ m |
quởng	q u ở n g |
rằng	r ằ n g |
biều	b i ề u |
mãnh	m ã n h |
sử	s ử |
sẩm	s ẩ m |
là	l à |
lữa	l ữ a |
cr	c r |
đốp	đ ố p |
tơi	t ơ i |
ngóm	n g ó m |
lùa	l ù a |
nguyên	n g u y ê n |
cao	c a o |
anot	a n o t |
rống	r ố n g |
gạnh	g ạ n h |
dollar	d o l l a r |
tày	t à y |
đéc	đ é c |
thiêm	t h i ê m |
vong	v o n g |
duệ	d u ệ |
mên	m ê n |
hấm	h ấ m |
hoen	h o e n |
rau	r a u |
xởn	x ở n |
cắc	c ắ c |
lã	l ã |
tôi	t ô i |
trạm	t r ạ m |
nhanh	n h a n h |
balông	b a l ô n g |
vóng	v ó n g |
trạo	t r ạ o |
nung	n u n g |
oang	o a n g |
tru	t r u |
lường	l ư ờ n g |
à	à |
hả	h ả |
buji	b u j i |
nhù	n h ù |
môt	m ô t |
nhẵn	n h ẵ n |
vịm	v ị m |
lun	l u n |
scrabble	s c r a b b l e |
bào	b à o |
giặt	g i ặ t |
dẽ	d ẽ |
nhọt	n h ọ t |
acetylen	a c e t y l e n |
phép	p h é p |
gơ	g ơ |
sói	s ó i |
glai	g l a i |
toét	t o é t |
đúp	đ ú p |
náu	n á u |
xamôva	x a m ô v a |
ruỗng	r u ỗ n g |
canxi	c a n x i |
ngáng	n g á n g |
mãng	m ã n g |
chiệc	c h i ệ c |
thập	t h ậ p |
quách	q u á c h |
quyệt	q u y ệ t |
mandolin	m a n d o l i n |
lãi	l ã i |
trịa	t r ị a |
emetine	e m e t i n e |
chìu	c h ì u |
xuể	x u ể |
tiếp	t i ế p |
tệp	t ệ p |
hẹc	h ẹ c |
phai	p h a i |
palan	p a l a n |
bún	b ú n |
khạng	k h ạ n g |
chông	c h ô n g |
sinhll	s i n h l l |
đực	đ ự c |
miết	m i ế t |
ngỡi	n g ỡ i |
khôống	k h ô ố n g |
đuých	đ u ý c h |
phà	p h à |
giăng	g i ă n g |
gạn	g ạ n |
tuồng	t u ồ n g |
bà	b à |
vốn	v ố n |
ngơ	n g ơ |
kv	k v |
lây	l â y |
xắc	x ắ c |
giga	g i g a |
mau	m a u |
montage	m o n t a g e |
tấc	t ấ c |
điệu	đ i ệ u |
lụng	l ụ n g |
xẽo	x ẽ o |
nằm	n ằ m |
nhoá	n h o á |
keo	k e o |
hon	h o n |
momo	m o m o |
boa	b o a |
lo	l o |
mòng	m ò n g |
tũm	t ũ m |
duỗi	d u ỗ i |
khùng	k h ù n g |
truỵ	t r u ỵ |
giúm	g i ú m |
chẽm	c h ẽ m |
bựt	b ự t |
dong	d o n g |
lệ	l ệ |
urani	u r a n i |
rời	r ờ i |
hồ	h ồ |
hằng	h ằ n g |
lẫm	l ẫ m |
đếm	đ ế m |
brơ	b r ơ |
sum	s u m |
đuôi	đ u ô i |
luộc	l u ộ c |
dèn	d è n |
quặc	q u ặ c |
chóc	c h ó c |
hang	h a n g |
đoa	đ o a |
urea	u r e a |
khấc	k h ấ c |
starter	s t a r t e r |
cướp	c ư ớ p |
kỹ	k ỹ |
nghành	n g h à n h |
rư	r ư |
au	a u |
ánh	á n h |
vách	v á c h |
kiệt	k i ệ t |
ẩn	ẩ n |
chíp	c h í p |
cọp	c ọ p |
crom	c r o m |
dóc	d ó c |
nhãng	n h ã n g |
thuý	t h u ý |
lõa	l õ a |
nữa	n ữ a |
xùng	x ù n g |
phắc	p h ắ c |
chuyết	c h u y ế t |
rìu	r ì u |
nhồm	n h ồ m |
muggle	m u g g l e |
phính	p h í n h |
dọn	d ọ n |
hẹp	h ẹ p |
lính	l í n h |
chạ	c h ạ |
êu	ê u |
thờl	t h ờ l |
dụi	d ụ i |
rontgen	r o n t g e n |
các	c á c |
zi	z i |
păh	p ă h |
ghẽ	g h ẽ |
xen	x e n |
tú	t ú |
lánh	l á n h |
khêu	k h ê u |
tủm	t ủ m |
soong	s o o n g |
chềnh	c h ề n h |
ngoẻo	n g o ẻ o |
hiếm	h i ế m |
xonat	x o n a t |
cation	c a t i o n |
nhúc	n h ú c |
vals	v a l s |
nhướn	n h ư ớ n |
hen	h e n |
vảy	v ả y |
bịnh	b ị n h |
đác	đ á c |
cấu	c ấ u |
chộp	c h ộ p |
fi	f i |
dốt	d ố t |
vẽ	v ẽ |
nxb	n x b |
ngủm	n g ủ m |
apphich	a p p h i c h |
ac	a c |
chớt	c h ớ t |
hây	h â y |
thuấn	t h u ấ n |
rạng	r ạ n g |
ít	í t |
trẽo	t r ẽ o |
lẹo	l ẹ o |
nàng	n à n g |
chíu	c h í u |
dáy	d á y |
chũn	c h ũ n |
phò	p h ò |
nằng	n ằ n g |
phạch	p h ạ c h |
stress	s t r e s s |
ngoắc	n g o ắ c |
liến	l i ế n |
nập	n ậ p |
đỗ	đ ỗ |
nần	n ầ n |
khào	k h à o |
giắt	g i ắ t |
tháu	t h á u |
kĩ	k ĩ |
vạm	v ạ m |
mẫm	m ẫ m |
khỏe	k h ỏ e |
quyển	q u y ể n |
píp	p í p |
vê	v ê |
hý	h ý |
sền	s ề n |
kom	k o m |
hòa	h ò a |
rở	r ở |
đõ	đ õ |
mrơn	m r ơ n |
ngò	n g ò |
troốc	t r o ố c |
nuột	n u ộ t |
catalogue	c a t a l o g u e |
xố	x ố |
xmô	x m ô |
nãy	n ã y |
nàn	n à n |
đao	đ a o |
gương	g ư ơ n g |
moa	m o a |
khuỵu	k h u ỵ u |
ỉu	ỉ u |
dữ	d ữ |
gáo	g á o |
soi	s o i |
đan	đ a n |
bakelit	b a k e l i t |
nực	n ự c |
coctison	c o c t i s o n |
giẫm	g i ẫ m |
sóm	s ó m |
xười	x ư ờ i |
axeton	a x e t o n |
đẵng	đ ẵ n g |
nhẽo	n h ẽ o |
ngòm	n g ò m |
uông	u ô n g |
liêm	l i ê m |
tgđ	t g đ |
lú	l ú |
gié	g i é |
chiều	c h i ề u |
phương	p h ư ơ n g |
gioi	g i o i |
chủ	c h ủ |
user	u s e r |
lẻo	l ẻ o |
clinke	c l i n k e |
giừ	g i ừ |
iota	i o t a |
riyal	r i y a l |
trụ	t r ụ |
giào	g i à o |
hòm	h ò m |
cafe	c a f e |
ngoảng	n g o ả n g |
mở	m ở |
kị	k ị |
in	i n |
khừa	k h ừ a |
nỏ	n ỏ |
phèo	p h è o |
đêu	đ ê u |
anmanac	a n m a n a c |
xam	x a m |
woát	w o á t |
xiên	x i ê n |
trọt	t r ọ t |
dém	d é m |
ấp	ấ p |
dúi	d ú i |
quất	q u ấ t |
dẻo	d ẻ o |
luốc	l u ố c |
pơng	p ơ n g |
đuy	đ u y |
sú	s ú |
sẩn	s ẩ n |
siếc	s i ế c |
chị	c h ị |
khự	k h ự |
pếch	p ế c h |
mg	m g |
tetracyclin	t e t r a c y c l i n |
ưu	ư u |
gót	g ó t |
chọn	c h ọ n |
triển	t r i ể n |
chơ	c h ơ |
nhắn	n h ắ n |
nhảu	n h ả u |
thòi	t h ò i |
hy	h y |
toi	t o i |
ỳ	ỳ |
bếu	b ế u |
wikipedia	w i k i p e d i a |
thỗn	t h ỗ n |
liu	l i u |
tấm	t ấ m |
dẳng	d ẳ n g |
phịt	p h ị t |
hành	h à n h |
villa	v i l l a |
cọ	c ọ |
chịt	c h ị t |
nghim	n g h i m |
mõm	m õ m |
quà	q u à |
rông	r ô n g |
rỉn	r ỉ n |
bắn	b ắ n |
ralum	r a l u m |
rinh	r i n h |
vôn	v ô n |
nghén	n g h é n |
puộc	p u ộ c |
xén	x é n |
ngàu	n g à u |
tau	t a u |
ngỡn	n g ỡ n |
khấu	k h ấ u |
hùm	h ù m |
chô	c h ô |
rịa	r ị a |
niêm	n i ê m |
ghình	g h ì n h |
ngưởng	n g ư ở n g |
quị	q u ị |
hia	h i a |
kina	k i n a |
strichnin	s t r i c h n i n |
pijama	p i j a m a |
tơrơt	t ơ r ơ t |
cạnh	c ạ n h |
quê	q u ê |
nỉ	n ỉ |
lượn	l ư ợ n |
củn	c ủ n |
lẽ	l ẽ |
giẫy	g i ẫ y |
hỗm	h ỗ m |
ở	ở |
silicat	s i l i c a t |
roneo	r o n e o |
gián	g i á n |
uẩn	u ẩ n |
đc	đ c |
riu	r i u |
cạc	c ạ c |
trây	t r â y |
fo	f o |
oeng	o e n g |
compact	c o m p a c t |
hồm	h ồ m |
du	d u |
ín	í n |
ttl	t t l |
giản	g i ả n |
lẹm	l ẹ m |
rừ	r ừ |
nài	n à i |
trọ	t r ọ |
nột	n ộ t |
mỏng	m ỏ n g |
rài	r à i |
thú	t h ú |
xòng	x ò n g |
gượng	g ư ợ n g |
ngưu	n g ư u |
ruộng	r u ộ n g |
thích	t h í c h |
dạo	d ạ o |
earth	e a r t h |
làm	l à m |
ktt	k t t |
ran	r a n |
nit	n i t |
campapura	c a m p a p u r a |
rại	r ạ i |
phong	p h o n g |
cậu	c ậ u |
lũm	l ũ m |
ngoẹo	n g o ẹ o |
campuchia	c a m p u c h i a |
nêm	n ê m |
oèo	o è o |
lấp	l ấ p |
nghỉ	n g h ỉ |
dề	d ề |
ncs	n c s |
blốc	b l ố c |
chóng	c h ó n g |
tw	t w |
tổn	t ổ n |
bhallê	b h a l l ê |
mang	m a n g |
modem	m o d e m |
nong	n o n g |
cồ	c ồ |
khụt	k h ụ t |
đích	đ í c h |
nuôi	n u ô i |
chăm	c h ă m |
tbuăn	t b u ă n |
galăng	g a l ă n g |
ấu	ấ u |
trè	t r è |
suốt	s u ố t |
dạng	d ạ n g |
lưòng	l ư ò n g |
xtíc	x t í c |
aptômát	a p t ô m á t |
nếu	n ế u |
giờ	g i ờ |
sulfat	s u l f a t |
tíc	t í c |
gbit	g b i t |
xi	x i |
nghèn	n g h è n |
tiềm	t i ề m |
photphorit	p h o t p h o r i t |
cựu	c ự u |
cỏng	c ỏ n g |
bazan	b a z a n |
ẹ	ẹ |
quể	q u ể |
diện	d i ệ n |
tụi	t ụ i |
khèo	k h è o |
tout	t o u t |
ee	e e |
nguậy	n g u ậ y |
thán	t h á n |
conxecto	c o n x e c t o |
thưng	t h ư n g |
đậu	đ ậ u |
lỵ	l ỵ |
hại	h ạ i |
nhao	n h a o |
tẹt	t ẹ t |
dt	d t |
hỏn	h ỏ n |
ngổ	n g ổ |
cải	c ả i |
chận	c h ậ n |
aldehyd	a l d e h y d |
rađium	r a đ i u m |
xúp	x ú p |
pín	p í n |
phĩnh	p h ĩ n h |
brom	b r o m |
nhửng	n h ử n g |
chù	c h ù |
đườngba	đ ư ờ n g b a |
nẵng	n ẵ n g |
florin	f l o r i n |
vổng	v ổ n g |
bủa	b ủ a |
săảm	s ă ả m |
chòi	c h ò i |
khế	k h ế |
pint	p i n t |
siu	s i u |
ửng	ử n g |
cùng	c ù n g |
mòn	m ò n |
tàu	t à u |
mú	m ú |
quẳn	q u ẳ n |
lùi	l ù i |
dâu	d â u |
tủ	t ủ |
tran	t r a n |
kén	k é n |
tiếm	t i ế m |
khắng	k h ắ n g |
mìnhliên	m ì n h l i ê n |
xính	x í n h |
pyrite	p y r i t e |
ubnd	u b n d |
thóp	t h ó p |
qui	q u i |
lửa	l ử a |
ren	r e n |
aaaaa	a a a a a |
tennis	t e n n i s |
pin	p i n |
lòng	l ò n g |
rủn	r ủ n |
lóng	l ó n g |
chẩn	c h ẩ n |
õbăng	õ b ă n g |
hàngtông	h à n g t ô n g |
lê	l ê |
làu	l à u |
khò	k h ò |
bức	b ứ c |
lùm	l ù m |
trường	t r ư ờ n g |
cỡm	c ỡ m |
sửa	s ử a |
tắc	t ắ c |
teletyp	t e l e t y p |
vaseline	v a s e l i n e |
loga	l o g a |
rậm	r ậ m |
cáng	c á n g |
như	n h ư |
mần	m ầ n |
el	e l |
dang	d a n g |
dáng	d á n g |
dam	d a m |
cá	c á |
ngói	n g ó i |
dẹp	d ẹ p |
lặng	l ặ n g |
pháo	p h á o |
ngồ	n g ồ |
tươm	t ư ơ m |
giêng	g i ê n g |
omega	o m e g a |
lướng	l ư ớ n g |
nghỉn	n g h ỉ n |
ngậu	n g ậ u |
dầu	d ầ u |
lò	l ò |
nhay	n h a y |
quen	q u e n |
rì	r ì |
sất	s ấ t |
le	l e |
sơn	s ơ n |
offset	o f f s e t |
rêm	r ê m |
lúp	l ú p |
thút	t h ú t |
lịm	l ị m |
thêm	t h ê m |
cacten	c a c t e n |
choạp	c h o ạ p |
phạng	p h ạ n g |
ten	t e n |
giãi	g i ã i |
tuôcnăng	t u ô c n ă n g |
nhỏ	n h ỏ |
nủa	n ủ a |
dì	d ì |
giút	g i ú t |
bón	b ó n |
họ	h ọ |
thỏi	t h ỏ i |
dãy	d ã y |
khâng	k h â n g |
xml	x m l |
pâu	p â u |
chỗi	c h ỗ i |
chách	c h á c h |
ngó	n g ó |
nuốm	n u ố m |
lambda	l a m b d a |
đương	đ ư ơ n g |
quắm	q u ắ m |
êm	ê m |
thãi	t h ã i |
xìa	x ì a |
phạt	p h ạ t |
côve	c ô v e |
đụt	đ ụ t |
dón	d ó n |
hđks	h đ k s |
bảnh	b ả n h |
cậm	c ậ m |
hem	h e m |
smach	s m a c h |
ngồng	n g ồ n g |
hãnh	h ã n h |
nhùn	n h ù n |
logarithm	l o g a r i t h m |
lạc	l ạ c |
xerenat	x e r e n a t |
kẽm	k ẽ m |
que	q u e |
gập	g ậ p |
xtơ	x t ơ |
tuya	t u y a |
alo	a l o |
trạnh	t r ạ n h |
ngũ	n g ũ |
ngu	n g u |
acetic	a c e t i c |
thùa	t h ù a |
oan	o a n |
trã	t r ã |
nhạy	n h ạ y |
mơn	m ơ n |
đumđum	đ u m đ u m |
lũn	l ũ n |
hếch	h ế c h |
xuây	x u â y |
úa	ú a |
nương	n ư ơ n g |
phụt	p h ụ t |
sàn	s à n |
ngoẻn	n g o ẻ n |
nghè	n g h è |
vùa	v ù a |
photpho	p h o t p h o |
viu	v i u |
gờn	g ờ n |
ồi	ồ i |
đỏi	đ ỏ i |
dángdại	d á n g d ạ i |
áy	á y |
hỉnh	h ỉ n h |
layơn	l a y ơ n |
nhồn	n h ồ n |
yoga	y o g a |
khmer	k h m e r |
xới	x ớ i |
măngtô	m ă n g t ô |
adv	a d v |
hoả	h o ả |
chĩn	c h ĩ n |
chết	c h ế t |
pán	p á n |
vảnh	v ả n h |
cợt	c ợ t |
trang	t r a n g |
huấn	h u ấ n |
lối	l ố i |
lạu	l ạ u |
thơi	t h ơ i |
tược	t ư ợ c |
lưới	l ư ớ i |
cuờng	c u ờ n g |
bừ	b ừ |
chao	c h a o |
phố	p h ố |
nano	n a n o |
cõm	c õ m |
oz	o z |
gian	g i a n |
dẫu	d ẫ u |
sắt	s ắ t |
phỉnh	p h ỉ n h |
biêt	b i ê t |
lùn	l ù n |
ró	r ó |
trảng	t r ả n g |
pn	p n |
cốp	c ố p |
truất	t r u ấ t |
miễn	m i ễ n |
vinilông	v i n i l ô n g |
lổm	l ổ m |
sứ	s ứ |
quạy	q u ạ y |
plây	p l â y |
vnch	v n c h |
vẳng	v ẳ n g |
australia	a u s t r a l i a |
tuốc	t u ố c |
tiện	t i ệ n |
tướn	t ư ớ n |
dồ	d ồ |
quylat	q u y l a t |
duyệt	d u y ệ t |
trum	t r u m |
kuyn	k u y n |
buýp	b u ý p |
ềnh	ề n h |
thổi	t h ổ i |
èo	è o |
khoeo	k h o e o |
híp	h í p |
xte	x t e |
đẽo	đ ẽ o |
xom	x o m |
gặc	g ặ c |
ria	r i a |
ký	k ý |
escudo	e s c u d o |
guitar	g u i t a r |
hủm	h ủ m |
kơi	k ơ i |
hển	h ể n |
xáp	x á p |
êke	ê k e |
giáo	g i á o |
tiến	t i ế n |
copfa	c o p f a |
niệt	n i ệ t |
ngoang	n g o a n g |
níc	n í c |
sau	s a u |
nhờn	n h ờ n |
đềm	đ ề m |
oạc	o ạ c |
trợn	t r ợ n |
cốc	c ố c |
axit	a x i t |
xiếu	x i ế u |
khen	k h e n |
oda	o d a |
dậy	d ậ y |
trục	t r ụ c |
triêu	t r i ê u |
oải	o ả i |
siểng	s i ể n g |
ty	t y |
i	i |
bền	b ề n |
cớn	c ớ n |
xút	x ú t |
phéng	p h é n g |
quy	q u y |
riễu	r i ễ u |
xuchiêng	x u c h i ê n g |
campadegar	c a m p a d e g a r |
ngươ	n g ư ơ |
tảng	t ả n g |
hớt	h ớ t |
bếnh	b ế n h |
hoàng	h o à n g |
ảo	ả o |
xấu	x ấ u |
ampe	a m p e |
hân	h â n |
xây	x â y |
uốn	u ố n |
ráp	r á p |
cúa	c ú a |
soái	s o á i |
bạnh	b ạ n h |
thẩm	t h ẩ m |
chữu	c h ữ u |
khắc	k h ắ c |
lém	l é m |
tuôn	t u ô n |
mấm	m ấ m |
hoãng	h o ã n g |
ngợ	n g ợ |
xê	x ê |
pua	p u a |
trổng	t r ổ n g |
ẹp	ẹ p |
cụ	c ụ |
vinh	v i n h |
thò	t h ò |
cụng	c ụ n g |
nấp	n ấ p |
choen	c h o e n |
compass	c o m p a s s |
thuốc	t h u ố c |
khoành	k h o à n h |
rợt	r ợ t |
ậc	ậ c |
ngờ	n g ờ |
ptsc	p t s c |
phừn	p h ừ n |
chực	c h ự c |
môtơ	m ô t ơ |
hừa	h ừ a |
bắng	b ắ n g |
át	á t |
hoảnh	h o ả n h |
ạnh	ạ n h |
mủng	m ủ n g |
quậy	q u ậ y |
oạp	o ạ p |
muỗng	m u ỗ n g |
chuồi	c h u ồ i |
giọng	g i ọ n g |
trèo	t r è o |
ngải	n g ả i |
li	l i |
vắc	v ắ c |
tếch	t ế c h |
mẻ	m ẻ |
vúc	v ú c |
bùa	b ù a |
lìm	l ì m |
celsius	c e l s i u s |
chựng	c h ự n g |
streptomixin	s t r e p t o m i x i n |
verb	v e r b |
nếch	n ế c h |
đtdđ	đ t d đ |
moi	m o i |
formol	f o r m o l |
xemina	x e m i n a |
ya	y a |
nghẹt	n g h ẹ t |
nụ	n ụ |
dubni	d u b n i |
chủn	c h ủ n |
phiệt	p h i ệ t |
cor	c o r |
chém	c h é m |
mili	m i l i |
rệu	r ệ u |
ễng	ễ n g |
ruê	r u ê |
trọng	t r ọ n g |
ủy	ủ y |
chập	c h ậ p |
logo	l o g o |
maltose	m a l t o s e |
app	a p p |
thiêu	t h i ê u |
calory	c a l o r y |
chét	c h é t |
hựu	h ự u |
f	f |
chành	c h à n h |
gửi	g ử i |
huynh	h u y n h |
kêpi	k ê p i |
oong	o o n g |
chlorat	c h l o r a t |
chờn	c h ờ n |
km	k m |
son	s o n |
xiều	x i ề u |
dumdum	d u m d u m |
quềnh	q u ề n h |
teletype	t e l e t y p e |
phộc	p h ộ c |
mluộm	m l u ộ m |
lanhtô	l a n h t ô |
nanh	n a n h |
khiêm	k h i ê m |
ngong	n g o n g |
xộn	x ộ n |
đuôn	đ u ô n |
rếch	r ế c h |
loang	l o a n g |
lintô	l i n t ô |
batket	b a t k e t |
isoenzym	i s o e n z y m |
mườn	m ư ờ n |
giá	g i á |
bùn	b ù n |
bậng	b ậ n g |
khầng	k h ầ n g |
gioong	g i o o n g |
gáp	g á p |
gin	g i n |
nồi	n ồ i |
uyên	u y ê n |
hứ	h ứ |
rap	r a p |
nổ	n ổ |
ting	t i n g |
mã	m ã |
móm	m ó m |
trúc	t r ú c |
bìa	b ì a |
oẹ	o ẹ |
xỏ	x ỏ |
lình	l ì n h |
cực	c ự c |
vđv	v đ v |
toác	t o á c |
gạ	g ạ |
cuống	c u ố n g |
chẽ	c h ẽ |
khiệng	k h i ệ n g |
slìn	s l ì n |
tarô	t a r ô |
ter	t e r |
sẵp	s ẵ p |
galen	g a l e n |
đản	đ ả n |
bò	b ò |
chưởi	c h ư ở i |
ngặt	n g ặ t |
evn	e v n |
noãn	n o ã n |
xượt	x ư ợ t |
lõi	l õ i |
dẫn	d ẫ n |
sâng	s â n g |
kẹo	k ẹ o |
nhẻo	n h ẻ o |
duy	d u y |
ní	n í |
trủ	t r ủ |
giặm	g i ặ m |
rủng	r ủ n g |
cacbin	c a c b i n |
xiêu	x i ê u |
mửa	m ử a |
nhóm	n h ó m |
đền	đ ề n |
gion	g i o n |
loạc	l o ạ c |
xậm	x ậ m |
a	a |
huyên	h u y ê n |
oáp	o á p |
khốc	k h ố c |
nđ	n đ |
shtt	s h t t |
vẩy	v ẩ y |
vanh	v a n h |
mám	m á m |
thừng	t h ừ n g |
phớ	p h ớ |
cảm	c ả m |
xể	x ể |
sco	s c o |
nhẻ	n h ẻ |
phầm	p h ầ m |
ướp	ư ớ p |
củabên	c ủ a b ê n |
tích	t í c h |
sở	s ở |
ớ	ớ |
sưa	s ư a |
carô	c a r ô |
nợ	n ợ |
mặn	m ặ n |
suê	s u ê |
mobilet	m o b i l e t |
gas	g a s |
ồng	ồ n g |
rưỡi	r ư ỡ i |
nhem	n h e m |
chằng	c h ằ n g |
moọc	m o ọ c |
quuyết	q u u y ế t |
kimono	k i m o n o |
thanh	t h a n h |
đl	đ l |
cẫu	c ẫ u |
lia	l i a |
ringgit	r i n g g i t |
xupap	x u p a p |
rổng	r ổ n g |
kỳ	k ỳ |
bút	b ú t |
bùi	b ù i |
kháp	k h á p |
sạn	s ạ n |
rạy	r ạ y |
họn	h ọ n |
sá	s á |
xoã	x o ã |
thẩn	t h ẩ n |
chúc	c h ú c |
dựt	d ự t |
trự	t r ự |
hoãn	h o ã n |
ngù	n g ù |
xtê	x t ê |
mỉm	m ỉ m |
tour	t o u r |
tíu	t í u |
telephon	t e l e p h o n |
xatanh	x a t a n h |
armenia	a r m e n i a |
tuyến	t u y ế n |
kelvin	k e l v i n |
mỉu	m ỉ u |
khựng	k h ự n g |
xĩnh	x ĩ n h |
bxl	b x l |
rãi	r ã i |
quanh	q u a n h |
sợi	s ợ i |
nếp	n ế p |
ngọ	n g ọ |
ổm	ổ m |
nhi	n h i |
vầy	v ầ y |
cnc	c n c |
bát	b á t |
elcb	e l c b |
ngoại	n g o ạ i |
canhkina	c a n h k i n a |
lón	l ó n |
huề	h u ề |
sô	s ô |
gien	g i e n |
dãi	d ã i |
gã	g ã |
yết	y ế t |
loáo	l o á o |
giảng	g i ả n g |
rãy	r ã y |
automat	a u t o m a t |
bfn	b f n |
lic	l i c |
dành	d à n h |
đen	đ e n |
kilogram	k i l o g r a m |
hủng	h ủ n g |
hảy	h ả y |
dến	d ế n |
nân	n â n |
luôn	l u ô n |
tạnh	t ạ n h |
phán	p h á n |
dộp	d ộ p |
dưng	d ư n g |
xờm	x ờ m |
đuột	đ u ộ t |
màu	m à u |
giượng	g i ư ợ n g |
nống	n ố n g |
mơ	m ơ |
khiển	k h i ể n |
amino	a m i n o |
suyễn	s u y ễ n |
bơm	b ơ m |
lệt	l ệ t |
tiẻn	t i ẻ n |
neon	n e o n |
bừa	b ừ a |
chìm	c h ì m |
ngún	n g ú n |
mị	m ị |
đính	đ í n h |
bốp	b ố p |
ngườì	n g ư ờ ì |
bêta	b ê t a |
chồm	c h ồ m |
ắp	ắ p |
sao	s a o |
ạm	ạ m |
nhá	n h á |
anofen	a n o f e n |
hoach	h o a c h |
suite	s u i t e |
tròng	t r ò n g |
hày	h à y |
quinacrin	q u i n a c r i n |
thoi	t h o i |
gớc	g ớ c |
di	d i |
hường	h ư ờ n g |
chẹo	c h ẹ o |
khái	k h á i |
niu	n i u |
đần	đ ầ n |
gra	g r a |
vã	v ã |
đổi	đ ổ i |
bôm	b ô m |
dế	d ế |
hotel	h o t e l |
báp	b á p |
phập	p h ậ p |
stacte	s t a c t e |
khua	k h u a |
cún	c ú n |
gở	g ở |
nhoay	n h o a y |
ổn	ổ n |
chén	c h é n |
nghẽo	n g h ẽ o |
nà	n à |
dác	d á c |
prep	p r e p |
sonata	s o n a t a |
blâu	b l â u |
phau	p h a u |
nặng	n ặ n g |
khèn	k h è n |
lĩ	l ĩ |
nại	n ạ i |
thái	t h á i |
quặt	q u ặ t |
rữa	r ữ a |
nồm	n ồ m |
để	đ ể |
lon	l o n |
name	n a m e |
đoàn	đ o à n |
lều	l ề u |
bên	b ê n |
sà	s à |
umo	u m o |
lie	l i e |
gỏng	g ỏ n g |
lụt	l ụ t |
lŏàn	l o à n |
thậm	t h ậ m |
hánh	h á n h |
màng	m à n g |
cleopatra	c l e o p a t r a |
nè	n è |
đeca	đ e c a |
trứng	t r ứ n g |
míp	m í p |
canke	c a n k e |
mép	m é p |
phược	p h ư ợ c |
treng	t r e n g |
vi	v i |
sân	s â n |
chùm	c h ù m |
buồn	b u ồ n |
tivi	t i v i |
huý	h u ý |
thuỳ	t h u ỳ |
den	d e n |
mấy	m ấ y |
đét	đ é t |
muôn	m u ô n |
phum	p h u m |
phơ	p h ơ |
rỗng	r ỗ n g |
hương	h ư ơ n g |
wor	w o r |
nẫn	n ẫ n |
hung	h u n g |
rằn	r ằ n |
tống	t ố n g |
ốm	ố m |
òng	ò n g |
vít	v í t |
cotangent	c o t a n g e n t |
ngổn	n g ổ n |
phượt	p h ư ợ t |
ồ	ồ |
trẫm	t r ẫ m |
chần	c h ầ n |
nẫu	n ẫ u |
dạc	d ạ c |
thánh	t h á n h |
hiêng	h i ê n g |
sắn	s ắ n |
gích	g í c h |
tĩ	t ĩ |
tấu	t ấ u |
khánh	k h á n h |
lặn	l ặ n |
bày	b à y |
đía	đ í a |
rốp	r ố p |
rít	r í t |
mây	m â y |
càn	c à n |
ngổm	n g ổ m |
optimal	o p t i m a l |
trặc	t r ặ c |
nhạn	n h ạ n |
són	s ó n |
tĩn	t ĩ n |
thắm	t h ắ m |
trày	t r à y |
tớt	t ớ t |
xem	x e m |
xe	x e |
tước	t ư ớ c |
nhoe	n h o e |
khật	k h ậ t |
xóng	x ó n g |
đôla	đ ô l a |
đọp	đ ọ p |
chật	c h ậ t |
phượng	p h ư ợ n g |
nhàbảy	n h à b ả y |
hụt	h ụ t |
nửa	n ử a |
sốc	s ố c |
nhởi	n h ở i |
bắt	b ắ t |
guốc	g u ố c |
vac	v a c |
albani	a l b a n i |
nhập	n h ậ p |
hể	h ể |
nsnd	n s n d |
nhẹm	n h ẹ m |
thỉ	t h ỉ |
téo	t é o |
ngỡ	n g ỡ |
sonnet	s o n n e t |
ẩy	ẩ y |
giũa	g i ũ a |
quáo	q u á o |
sểnh	s ể n h |
xỉn	x ỉ n |
chốn	c h ố n |
túm	t ú m |
ỏm	ỏ m |
téc	t é c |
thoạt	t h o ạ t |
calô	c a l ô |
vấn	v ấ n |
nhức	n h ứ c |
đụi	đ ụ i |
sui	s u i |
bu	b u |
đút	đ ú t |
phạm	p h ạ m |
soda	s o d a |
loẻo	l o ẻ o |
xuốngmà	x u ố n g m à |
buông	b u ô n g |
ion	i o n |
quặm	q u ặ m |
pằn	p ằ n |
sích	s í c h |
liên	l i ê n |
đê	đ ê |
thoán	t h o á n |
xúy	x ú y |
poọng	p o ọ n g |
thẻ	t h ẻ |
thuần	t h u ầ n |
guồi	g u ồ i |
ngoạ	n g o ạ |
dỗ	d ỗ |
ngoãn	n g o ã n |
qué	q u é |
lồi	l ồ i |
xảy	x ả y |
hoá	h o á |
thất	t h ấ t |
ximôkinh	x i m ô k i n h |
bazooka	b a z o o k a |
tình	t ì n h |
vành	v à n h |
thuồng	t h u ồ n g |
thau	t h a u |
bặng	b ặ n g |
hưởng	h ư ở n g |
chiêu	c h i ê u |
hộp	h ộ p |
trỏ	t r ỏ |
ối	ố i |
jíp	j í p |
kéo	k é o |
sỏi	s ỏ i |
sến	s ế n |
hydrocarbon	h y d r o c a r b o n |
huỷ	h u ỷ |
tớ	t ớ |
giây	g i â y |
đkz	đ k z |
rổi	r ổ i |
bồ	b ồ |
cú	c ú |
mon	m o n |
đong	đ o n g |
sì	s ì |
dép	d é p |
hợp	h ợ p |
xtích	x t í c h |
basic	b a s i c |
ấm	ấ m |
mọp	m ọ p |
vắt	v ắ t |
re	r e |
tể	t ể |
sỉ	s ỉ |
giọ	g i ọ |
chọt	c h ọ t |
ngoạc	n g o ạ c |
liệc	l i ệ c |
huyễn	h u y ễ n |
catalô	c a t a l ô |
chạy	c h ạ y |
lả	l ả |
ương	ư ơ n g |
loáy	l o á y |
cức	c ứ c |
muội	m u ộ i |
thầm	t h ầ m |
đám	đ á m |
chẻ	c h ẻ |
phọp	p h ọ p |
ngàm	n g à m |
húy	h ú y |
khả	k h ả |
xổi	x ổ i |
trau	t r a u |
nhổng	n h ổ n g |
nhắt	n h ắ t |
gặng	g ặ n g |
bâng	b â n g |
gì	g ì |
cặm	c ặ m |
vn	v n |
ngứt	n g ứ t |
hên	h ê n |
xoóc	x o ó c |
yen	y e n |
tun	t u n |
moocchê	m o o c c h ê |
trưa	t r ư a |
loàng	l o à n g |
gỵa	g ỵ a |
chiếng	c h i ế n g |
ngước	n g ư ớ c |
lét	l é t |
đẹn	đ ẹ n |
và	v à |
húc	h ú c |
thưc	t h ư c |
nháy	n h á y |
dùn	d ù n |
kho	k h o |
hằm	h ằ m |
balê	b a l ê |
chênh	c h ê n h |
ơf	ơ f |
lênh	l ê n h |
duơn	d u ơ n |
páo	p á o |
abscess	a b s c e s s |
phồn	p h ồ n |
mưaem	m ư a e m |
liền	l i ề n |
ứn	ứ n |
giẵm	g i ẵ m |
bỏn	b ỏ n |
lỡi	l ỡ i |
thóa	t h ó a |
địnhtrường	đ ị n h t r ư ờ n g |
hớp	h ớ p |
lơ	l ơ |
tạc	t ạ c |
tatăng	t a t ă n g |
oái	o á i |
xềm	x ề m |
trụng	t r ụ n g |
đuốc	đ u ố c |
gí	g í |
gọi	g ọ i |
nhẳng	n h ẳ n g |
vĩ	v ĩ |
cạu	c ạ u |
kiều	k i ề u |
l	l |
gầm	g ầ m |
đuya	đ u y a |
cafê	c a f ê |
hàu	h à u |
dun	d u n |
hầy	h ầ y |
phidê	p h i d ê |
tăngsê	t ă n g s ê |
từ	t ừ |
nhẫm	n h ẫ m |
jor	j o r |
gi	g i |
lệch	l ệ c h |
som	s o m |
peso	p e s o |
xí	x í |
thuyết	t h u y ế t |
vỏn	v ỏ n |
hạ	h ạ |
ẩng	ẩ n g |
đằng	đ ằ n g |
mastic	m a s t i c |
xoa	x o a |
phả	p h ả |
pui	p u i |
ôkê	ô k ê |
phơn	p h ơ n |
cỡ	c ỡ |
chăn	c h ă n |
shilling	s h i l l i n g |
nhắm	n h ắ m |
ịch	ị c h |
hóng	h ó n g |
giậu	g i ậ u |
phôm	p h ô m |
rảy	r ả y |
almanach	a l m a n a c h |
cánh	c á n h |
diêu	d i ê u |
rađiô	r a đ i ô |
ev	e v |
bạch	b ạ c h |
vùi	v ù i |
thử	t h ử |
islam	i s l a m |
buột	b u ộ t |
apxe	a p x e |
nghền	n g h ề n |
chua	c h u a |
trông	t r ô n g |
trụp	t r ụ p |
tổng	t ổ n g |
thuốn	t h u ố n |
níu	n í u |
vứt	v ứ t |
náo	n á o |
vẹt	v ẹ t |
ngỏn	n g ỏ n |
dênh	d ê n h |
ngoeo	n g o e o |
rường	r ư ờ n g |
mấu	m ấ u |
xoẻng	x o ẻ n g |
nhãi	n h ã i |
sóng	s ó n g |
bem	b e m |
nính	n í n h |
đắp	đ ắ p |
ku	k u |
ka	k a |
phộ	p h ộ |
hning	h n i n g |
hấp	h ấ p |
graphite	g r a p h i t e |
loong	l o o n g |
xọc	x ọ c |
sấp	s ấ p |
động	đ ộ n g |
đắt	đ ắ t |
xẩu	x ẩ u |
guột	g u ộ t |
bichcôt	b i c h c ô t |
gìặt	g ì ặ t |
rịch	r ị c h |
liếm	l i ế m |
mươn	m ư ơ n |
lồm	l ồ m |
dẳn	d ẳ n |
vướng	v ư ớ n g |
phì	p h ì |
phót	p h ó t |
zích	z í c h |
amian	a m i a n |
gmt	g m t |
đớt	đ ớ t |
dioxin	d i o x i n |
mềm	m ề m |
kủo	k ủ o |
triệng	t r i ệ n g |
kéc	k é c |
khoải	k h o ả i |
carbonat	c a r b o n a t |
tãi	t ã i |
giỏi	g i ỏ i |
mặc	m ặ c |
chỏng	c h ỏ n g |
tành	t à n h |
bônsêvich	b ô n s ê v i c h |
web	w e b |
conxoocxiom	c o n x o o c x i o m |
luồi	l u ồ i |
sẵn	s ẵ n |
hót	h ó t |
lẻng	l ẻ n g |
trụy	t r ụ y |
khít	k h í t |
rá	r á |
bện	b ệ n |
phái	p h á i |
sệ	s ệ |
trằn	t r ằ n |
lanh	l a n h |
quý	q u ý |
pét	p é t |
viết	v i ế t |
cúng	c ú n g |
xói	x ó i |
trấp	t r ấ p |
khươi	k h ư ơ i |
dalasi	d a l a s i |
ruột	r u ộ t |
lẫn	l ẫ n |
ngoạn	n g o ạ n |
unicode	u n i c o d e |
quých	q u ý c h |
bancông	b a n c ô n g |
vơi	v ơ i |
hừm	h ừ m |
đện	đ ệ n |
chung	c h u n g |
afghani	a f g h a n i |
oé	o é |
chóp	c h ó p |
lõm	l õ m |
thẽ	t h ẽ |
nhớm	n h ớ m |
éo	é o |
nhành	n h à n h |
toefl	t o e f l |
chỉ	c h ỉ |
sộ	s ộ |
doãn	d o ã n |
mẩy	m ẩ y |
koruna	k o r u n a |
quây	q u â y |
chạo	c h ạ o |
sơmi	s ơ m i |
lóe	l ó e |
website	w e b s i t e |
quến	q u ế n |
linh	l i n h |
xợt	x ợ t |
nó	n ó |
thạnh	t h ạ n h |
hạt	h ạ t |
liếp	l i ế p |
nèo	n è o |
cẫm	c ẫ m |
hèm	h è m |
qs	q s |
tom	t o m |
doa	d o a |
thiệt	t h i ệ t |
sè	s è |
mún	m ú n |
ngon	n g o n |
phỗng	p h ỗ n g |
trẻ	t r ẻ |
bia	b i a |
nôm	n ô m |
chụt	c h ụ t |
dâng	d â n g |
vợ	v ợ |
cồm	c ồ m |
loẻng	l o ẻ n g |
tòn	t ò n |
xuynh	x u y n h |
hợi	h ợ i |
cacao	c a c a o |
hdi	h d i |
euro	e u r o |
ok	o k |
kiễng	k i ễ n g |
xtrết	x t r ế t |
seo	s e o |
quỹ	q u ỹ |
chớ	c h ớ |
lavabô	l a v a b ô |
tâu	t â u |
xấc	x ấ c |
phân	p h â n |
mại	m ạ i |
tĩnh	t ĩ n h |
ngượng	n g ư ợ n g |
baren	b a r e n |
lempira	l e m p i r a |
tửu	t ử u |
đật	đ ậ t |
lún	l ú n |
lức	l ứ c |
ném	n é m |
hoằn	h o ằ n |
nhẹo	n h ẹ o |
tím	t í m |
dượi	d ư ợ i |
sốkhông	s ố k h ô n g |
phành	p h à n h |
tám	t á m |
sịt	s ị t |
graphit	g r a p h i t |
lở	l ở |
rộ	r ộ |
nhinh	n h i n h |
nhậm	n h ậ m |
è	è |
đót	đ ó t |
tàn	t à n |
vệt	v ệ t |
mạnh	m ạ n h |
khỏng	k h ỏ n g |
da	d a |
mệ	m ệ |
bứa	b ứ a |
xấp	x ấ p |
gìm	g ì m |
nhõn	n h õ n |
chấn	c h ấ n |
thê	t h ê |
tareh	t a r e h |
nanômét	n a n ô m é t |
đùm	đ ù m |
diễn	d i ễ n |
nện	n ệ n |
hát	h á t |
phốc	p h ố c |
lếc	l ế c |
xổng	x ổ n g |
chuội	c h u ộ i |
đàng	đ à n g |
váp	v á p |
trơn	t r ơ n |
lưởi	l ư ở i |
mớn	m ớ n |
tính	t í n h |
kcs	k c s |
toen	t o e n |
nga	n g a |
nhối	n h ố i |
thết	t h ế t |
bần	b ầ n |
bặm	b ặ m |
ozon	o z o n |
bùm	b ù m |
cợn	c ợ n |
hú	h ú |
quếnh	q u ế n h |
hsi	h s i |
mém	m é m |
mc	m c |
nhả	n h ả |
têm	t ê m |
ju	j u |
hộ	h ộ |
xuý	x u ý |
nghễu	n g h ễ u |
siểm	s i ể m |
tùm	t ù m |
dính	d í n h |
lati	l a t i |
làn	l à n |
gụi	g ụ i |
khẽ	k h ẽ |
nì	n ì |
tl	t l |
tâ	t â |
vạn	v ạ n |
núc	n ú c |
macxit	m a c x i t |
củm	c ủ m |
hi	h i |
bẹn	b ẹ n |
bỡ	b ỡ |
tòe	t ò e |
ỉ	ỉ |
mazut	m a z u t |
dót	d ó t |
nhớn	n h ớ n |
bêtông	b ê t ô n g |
khoi	k h o i |
xéc	x é c |
hydroxid	h y d r o x i d |
batrui	b a t r u i |
péc	p é c |
mác	m á c |
nghển	n g h ể n |
ngừa	n g ừ a |
tala	t a l a |
tem	t e m |
htx	h t x |
nẫng	n ẫ n g |
giấm	g i ấ m |
giẳn	g i ẳ n |
phượu	p h ư ợ u |
jaz	j a z |
soài	s o à i |
dyne	d y n e |
krone	k r o n e |
dậm	d ậ m |
răm	r ă m |
rườm	r ư ờ m |
úi	ú i |
nhĩ	n h ĩ |
láu	l á u |
đura	đ u r a |
niền	n i ề n |
thùy	t h ù y |
tằm	t ằ m |
nghĩnh	n g h ĩ n h |
ồn	ồ n |
hậm	h ậ m |
trúng	t r ú n g |
khoáng	k h o á n g |
iốt	i ố t |
mêđia	m ê đ i a |
hoăng	h o ă n g |
nhoang	n h o a n g |
tum	t u m |
pda	p d a |
đằm	đ ằ m |
rệch	r ệ c h |
bập	b ậ p |
đrá	đ r á |
soạp	s o ạ p |
tở	t ở |
trạy	t r ạ y |
kappa	k a p p a |
thột	t h ộ t |
foóc	f o ó c |
đpcm	đ p c m |
thốn	t h ố n |
thẻo	t h ẻ o |
titanium	t i t a n i u m |
cội	c ộ i |
kb	k b |
chổi	c h ổ i |
thắc	t h ắ c |
lỏng	l ỏ n g |
mênh	m ê n h |
phắp	p h ắ p |
nhở	n h ở |
mờ	m ờ |
cùn	c ù n |
lựng	l ự n g |
hẳn	h ẳ n |
ngăm	n g ă m |
luých	l u ý c h |
cuaroa	c u a r o a |
nghiã	n g h i ã |
dạcó	d ạ c ó |
rivê	r i v ê |
mail	m a i l |
real	r e a l |
gai	g a i |
ngám	n g á m |
nạnh	n ạ n h |
glaucoma	g l a u c o m a |
culi	c u l i |
nôi	n ô i |
sua	s u a |
jin	j i n |
chuộc	c h u ộ c |
khừ	k h ừ |
trằng	t r ằ n g |
nhịt	n h ị t |
mụ	m ụ |
sẹp	s ẹ p |
rám	r á m |
liễu	l i ễ u |
uyn	u y n |
sêu	s ê u |
maltos	m a l t o s |
sức	s ứ c |
thỉu	t h ỉ u |
toáy	t o á y |
ầm	ầ m |
nhoáng	n h o á n g |
phìa	p h ì a |
giở	g i ở |
súy	s ú y |
hỏa	h ỏ a |
ngoem	n g o e m |
lầm	l ầ m |
iod	i o d |
tõm	t õ m |
tơn	t ơ n |
cara	c a r a |
căn	c ă n |
lấm	l ấ m |
úy	ú y |
giáy	g i á y |
dảy	d ả y |
pu	p u |
ghềnh	g h ề n h |
sòn	s ò n |
rún	r ú n |
lứt	l ứ t |
ak	a k |
nên	n ê n |
nậu	n ậ u |
nghệu	n g h ệ u |
hư	h ư |
trướng	t r ư ớ n g |
trí	t r í |
trẽ	t r ẽ |
tulip	t u l i p |
cúi	c ú i |
fizê	f i z ê |
lảo	l ả o |
toán	t o á n |
vẻ	v ẻ |
văng	v ă n g |
ngậy	n g ậ y |
đẹt	đ ẹ t |
thộn	t h ộ n |
chọ	c h ọ |
khé	k h é |
thoại	t h o ạ i |
oát	o á t |
bác	b á c |
mượt	m ư ợ t |
khoong	k h o o n g |
chừng	c h ừ n g |
ôpêra	ô p ê r a |
nếm	n ế m |
thửa	t h ử a |
xầu	x ầ u |
mẹo	m ẹ o |
kilogam	k i l o g a m |
dể	d ể |
sẽ	s ẽ |
mày	m à y |
rock	r o c k |
peseta	p e s e t a |
volt	v o l t |
đùn	đ ù n |
bít	b í t |
cặn	c ặ n |
dò	d ò |
mệt	m ệ t |
nớp	n ớ p |
ups	u p s |
khàn	k h à n |
phỉ	p h ỉ |
thúc	t h ú c |
vãi	v ã i |
sồ	s ồ |
giàu	g i à u |
yard	y a r d |
thủm	t h ủ m |
ngoéo	n g o é o |
mọ	m ọ |
êga	ê g a |
pha	p h a |
foot	f o o t |
vồn	v ồ n |
sại	s ạ i |
nịu	n ị u |
queng	q u e n g |
thè	t h è |
mịt	m ị t |
trachoma	t r a c h o m a |
dộc	d ộ c |
kỵ	k ỵ |
uầy	u ầ y |
eo	e o |
biên	b i ê n |
trúm	t r ú m |
sầu	s ầ u |
lán	l á n |
hiền	h i ề n |
thùng	t h ù n g |
ự	ự |
hống	h ố n g |
bih	b i h |
hàm	h à m |
mưỡu	m ư ỡ u |
đĩ	đ ĩ |
ruýp	r u ý p |
sướng	s ư ớ n g |
lêninit	l ê n i n i t |
gòn	g ò n |
gỡ	g ỡ |
tram	t r a m |
cacbonat	c a c b o n a t |
liềm	l i ề m |
panel	p a n e l |
khe	k h e |
mocphin	m o c p h i n |
bộn	b ộ n |
sây	s â y |
chúm	c h ú m |
chễnh	c h ễ n h |
xắp	x ắ p |
vụ	v ụ |
rua	r u a |
melo	m e l o |
lũ	l ũ |
cntb	c n t b |
ngứa	n g ứ a |
nản	n ả n |
trầm	t r ầ m |
òa	ò a |
gài	g à i |
permanganat	p e r m a n g a n a t |
tỷ	t ỷ |
giỏn	g i ỏ n |
vổ	v ổ |
săm	s ă m |
hủi	h ủ i |
truông	t r u ô n g |
mèm	m è m |
giầm	g i ầ m |
sác	s á c |
tẩy	t ẩ y |
cafein	c a f e i n |
rỏm	r ỏ m |
leo	l e o |
nghí	n g h í |
hoạt	h o ạ t |
monomer	m o n o m e r |
mol	m o l |
biptêt	b i p t ê t |
phựa	p h ự a |
hỡi	h ỡ i |
chàng	c h à n g |
thằng	t h ằ n g |
khéo	k h é o |
cui	c u i |
hệt	h ệ t |
chát	c h á t |
đi	đ i |
xịch	x ị c h |
khử	k h ử |
rỉa	r ỉ a |
dặng	d ặ n g |
khoặm	k h o ặ m |
rờ	r ờ |
giảo	g i ả o |
truồi	t r u ồ i |
chéo	c h é o |
nùn	n ù n |
ói	ó i |
đom	đ o m |
lỗm	l ỗ m |
thộc	t h ộ c |
ráo	r á o |
ngâu	n g â u |
rụng	r ụ n g |
căng	c ă n g |
trườngề	t r ư ờ n g ề |
ờ	ờ |
mổng	m ổ n g |
kỉm	k ỉ m |
găm	g ă m |
rulô	r u l ô |
sma	s m a |
doping	d o p i n g |
phiêu	p h i ê u |
nít	n í t |
măm	m ă m |
xnk	x n k |
gia	g i a |
hormon	h o r m o n |
chương	c h ư ơ n g |
niña	n i n a |
khá	k h á |
chlorhydric	c h l o r h y d r i c |
giãy	g i ã y |
mộng	m ộ n g |
nguội	n g u ộ i |
rượu	r ư ợ u |
dẩm	d ẩ m |
thống	t h ố n g |
rit	r i t |
xẩy	x ẩ y |
xệp	x ệ p |
yê	y ê |
ngõa	n g õ a |
pô	p ô |
luấn	l u ấ n |
rứt	r ứ t |
rền	r ề n |
dị	d ị |
khâm	k h â m |
dúa	d ú a |
nhõm	n h õ m |
ngụ	n g ụ |
cp	c p |
stơ	s t ơ |
xalông	x a l ô n g |
tất	t ấ t |
adj	a d j |
hê	h ê |
yun	y u n |
vầu	v ầ u |
chụp	c h ụ p |
ngộ	n g ộ |
phỏng	p h ỏ n g |
tui	t u i |
ximăng	x i m ă n g |
hydroponic	h y d r o p o n i c |
tùy	t ù y |
braian	b r a i a n |
ùng	ù n g |
mark	m a r k |
atmosphere	a t m o s p h e r e |
nhổn	n h ổ n |
chẫu	c h ẫ u |
trên	t r ê n |
marx	m a r x |
npc	n p c |
rụm	r ụ m |
chượng	c h ư ợ n g |
bánh	b á n h |
pơluya	p ơ l u y a |
lăn	l ă n |
kỉnh	k ỉ n h |
ệt	ệ t |
khất	k h ấ t |
giội	g i ộ i |
ounce	o u n c e |
thần	t h ầ n |
lảy	l ả y |
loằn	l o ằ n |
bịch	b ị c h |
neuron	n e u r o n |
xiển	x i ể n |
fenspat	f e n s p a t |
fatxit	f a t x i t |
dậu	d ậ u |
quân	q u â n |
đồm	đ ồ m |
nhoi	n h o i |
rẻng	r ẻ n g |
dệu	d ệ u |
rặn	r ặ n |
adn	a d n |
đéo	đ é o |
bẻm	b ẻ m |
ghìm	g h ì m |
pi	p i |
căngtin	c ă n g t i n |
oanh	o a n h |
ngụy	n g ụ y |
transistor	t r a n s i s t o r |
ừ	ừ |
cối	c ố i |
điểu	đ i ể u |
kẹn	k ẹ n |
đáp	đ á p |
khuẩn	k h u ẩ n |
ã	ã |
bobbin	b o b b i n |
voan	v o a n |
chẫn	c h ẫ n |
vùng	v ù n g |
ước	ư ớ c |
sù	s ù |
dức	d ứ c |
oa	o a |
vị	v ị |
lòn	l ò n |
đãng	đ ã n g |
củ	c ủ |
khăm	k h ă m |
hec	h e c |
lắp	l ắ p |
nhót	n h ó t |
trân	t r â n |
dõi	d õ i |
chẩu	c h ẩ u |
tẹp	t ẹ p |
viôlôngxen	v i ô l ô n g x e n |
cadmium	c a d m i u m |
xịt	x ị t |
diếc	d i ế c |
gan	g a n |
khanh	k h a n h |
rù	r ù |
nhịn	n h ị n |
ám	á m |
gàn	g à n |
hiên	h i ê n |
boliviano	b o l i v i a n o |
nhều	n h ề u |
quau	q u a u |
triều	t r i ề u |
mưa	m ư a |
tín	t í n |
thiên	t h i ê n |
nhỡn	n h ỡ n |
trụm	t r ụ m |
sấy	s ấ y |
diên	d i ê n |
pôông	p ô ô n g |
nũy	n ũ y |
doanh	d o a n h |
diesel	d i e s e l |
nhệch	n h ệ c h |
dợm	d ợ m |
nghề	n g h ề |
ngẳng	n g ẳ n g |
mỉa	m ỉ a |
kroon	k r o o n |
rọt	r ọ t |
hóp	h ó p |
gúa	g ú a |
tuyên	t u y ê n |
lụi	l ụ i |
sổi	s ổ i |
khàng	k h à n g |
patê	p a t ê |
phàn	p h à n |
quỵp	q u ỵ p |
cùi	c ù i |
dếch	d ế c h |
quạch	q u ạ c h |
ịn	ị n |
đươc	đ ư ơ c |
khoán	k h o á n |
khẳn	k h ẳ n |
lễu	l ễ u |
trển	t r ể n |
huống	h u ố n g |
ngạ	n g ạ |
đinamo	đ i n a m o |
m	m |
lệnh	l ệ n h |
tế	t ế |
xoay	x o a y |
thuổc	t h u ổ c |
tốc	t ố c |
ngoách	n g o á c h |
ngấm	n g ấ m |
bro	b r o |
môtô	m ô t ô |
khẩu	k h ẩ u |
th	t h |
soạng	s o ạ n g |
israel	i s r a e l |
bụi	b ụ i |
hippy	h i p p y |
toòng	t o ò n g |
đồi	đ ồ i |
marathon	m a r a t h o n |
xêri	x ê r i |
bơ	b ơ |
tộp	t ộ p |
xắm	x ắ m |
trung	t r u n g |
plăng	p l ă n g |
dvd	d v d |
phang	p h a n g |
lim	l i m |
đađa	đ a đ a |
yến	y ế n |
chỏ	c h ỏ |
bối	b ố i |
huầy	h u ầ y |
nghẹo	n g h ẹ o |
agar	a g a r |
mèo	m è o |
quetzal	q u e t z a l |
oăng	o ă n g |
ôtôca	ô t ô c a |
nờm	n ờ m |
chày	c h à y |
dol	d o l |
đum	đ u m |
sừn	s ừ n |
toả	t o ả |
polietylen	p o l i e t y l e n |
xki	x k i |
nượp	n ư ợ p |
hớ	h ớ |
acre	a c r e |
châu	c h â u |
qua	q u a |
mót	m ó t |
đoành	đ o à n h |
đèo	đ è o |
chlor	c h l o r |
ohm	o h m |
ộn	ộ n |
nhén	n h é n |
megabyte	m e g a b y t e |
tièn	t i è n |
opera	o p e r a |
spat	s p a t |
phua	p h u a |
ngổng	n g ổ n g |
sạp	s ạ p |
thứ	t h ứ |
hẩm	h ẩ m |
hacker	h a c k e r |
dinar	d i n a r |
ủi	ủ i |
xơcua	x ơ c u a |
krang	k r a n g |
côsin	c ô s i n |
loà	l o à |
hận	h ậ n |
lấy	l ấ y |
khơme	k h ơ m e |
tông	t ô n g |
xúa	x ú a |
bạ	b ạ |
thài	t h à i |
trợ	t r ợ |
giáp	g i á p |
xưa	x ư a |
rối	r ố i |
mạ	m ạ |
khuều	k h u ề u |
lượm	l ư ợ m |
thiểu	t h i ể u |
gelatin	g e l a t i n |
sôpphơ	s ô p p h ơ |
hoắt	h o ắ t |
kilooat	k i l o o a t |
nùi	n ù i |
tơrưng	t ơ r ư n g |
comlê	c o m l ê |
nhuộm	n h u ộ m |
mp	m p |
gatô	g a t ô |
gộ	g ộ |
ngần	n g ầ n |
tônô	t ô n ô |
ườn	ư ờ n |
choi	c h o i |
hydroxide	h y d r o x i d e |
anpha	a n p h a |
nitric	n i t r i c |
showroom	s h o w r o o m |
hị	h ị |
xuy	x u y |
nhôm	n h ô m |
nylon	n y l o n |
đụ	đ ụ |
vốc	v ố c |
choè	c h o è |
ôm	ô m |
hong	h o n g |
khong	k h o n g |
tối	t ố i |
ẩm	ẩ m |
yang	y a n g |
cổng	c ổ n g |
ốt	ố t |
đứt	đ ứ t |
ngảng	n g ả n g |
róm	r ó m |
cả	c ả |
rên	r ê n |
bậy	b ậ y |
lẻm	l ẻ m |
trìu	t r ì u |
xiểm	x i ể m |
đói	đ ó i |
mướp	m ư ớ p |
đỗi	đ ỗ i |
rú	r ú |
nội	n ộ i |
pleiku	p l e i k u |
lipid	l i p i d |
hổphường	h ổ p h ư ờ n g |
xoác	x o á c |
yểu	y ể u |
bêu	b ê u |
khủng	k h ủ n g |
tịu	t ị u |
blô	b l ô |
ni	n i |
bín	b í n |
radium	r a d i u m |
đớp	đ ớ p |
nhắng	n h ắ n g |
bặn	b ặ n |
quờ	q u ờ |
rĩn	r ĩ n |
radio	r a d i o |
rưng	r ư n g |
khum	k h u m |
khoảng	k h o ả n g |
lụn	l ụ n |
mật	m ậ t |
nghì	n g h ì |
sùi	s ù i |
bèn	b è n |
hẵm	h ẵ m |
kiềng	k i ề n g |
xạ	x ạ |
điếng	đ i ế n g |
hươn	h ư ơ n |
bớt	b ớ t |
đạn	đ ạ n |
ebonite	e b o n i t e |
buồm	b u ồ m |
thă	t h ă |
tóm	t ó m |
đúng	đ ú n g |
đôi	đ ô i |
dàm	d à m |
bóc	b ó c |
nghiêng	n g h i ê n g |
sủi	s ủ i |
hè	h è |
hờ	h ờ |
nguyền	n g u y ề n |
gẩm	g ẩ m |
chuểnh	c h u ể n h |
dinh	d i n h |
trơ	t r ơ |
dưa	d ư a |
loán	l o á n |
nhặt	n h ặ t |
nhiếc	n h i ế c |
lởi	l ở i |
ml	m l |
ươm	ư ơ m |
moong	m o o n g |
scotland	s c o t l a n d |
apartheid	a p a r t h e i d |
lôn	l ô n |
ầu	ầ u |
vồ	v ồ |
nác	n á c |
sin	s i n |
giạm	g i ạ m |
trịt	t r ị t |
đòn	đ ò n |
sương	s ư ơ n g |
ric	r i c |
khuyến	k h u y ế n |
thu	t h u |
hễ	h ễ |
jút	j ú t |
xy	x y |
loai	l o a i |
nghều	n g h ề u |
buối	b u ố i |
xáo	x á o |
tráp	t r á p |
nhợt	n h ợ t |
nhờm	n h ờ m |
lậy	l ậ y |
thung	t h u n g |
gấm	g ấ m |
bão	b ã o |
giùi	g i ù i |
quỵ	q u ỵ |
suông	s u ô n g |
trồ	t r ồ |
rán	r á n |
nhuếnh	n h u ế n h |
phắt	p h ắ t |
ộ	ộ |
hoánh	h o á n h |
sọ	s ọ |
curoa	c u r o a |
triết	t r i ế t |
ách	á c h |
hoáng	h o á n g |
nguých	n g u ý c h |
sầy	s ầ y |
song	s o n g |
barie	b a r i e |
táng	t á n g |
hất	h ấ t |
mượn	m ư ợ n |
muồi	m u ồ i |
đưa	đ ư a |
lơi	l ơ i |
ui	u i |
lan	l a n |
nua	n u a |
lọn	l ọ n |
phấn	p h ấ n |
vẩn	v ẩ n |
model	m o d e l |
khóa	k h ó a |
entropy	e n t r o p y |
cộ	c ộ |
vánh	v á n h |
nhại	n h ạ i |
lưỡí	l ư ỡ í |
tếu	t ế u |
xạch	x ạ c h |
húp	h ú p |
khọm	k h ọ m |
lõng	l õ n g |
protide	p r o t i d e |
áng	á n g |
hoét	h o é t |
rađa	r a đ a |
trưỡng	t r ư ỡ n g |
cosin	c o s i n |
jun	j u n |
khổng	k h ổ n g |
sõi	s õ i |
đóa	đ ó a |
saccharin	s a c c h a r i n |
pccc	p c c c |
cặt	c ặ t |
đốn	đ ố n |
phìn	p h ì n |
bọp	b ọ p |
anbom	a n b o m |
lểu	l ể u |
rỏi	r ỏ i |
ứa	ứ a |
nghẹn	n g h ẹ n |
rềnh	r ề n h |
phuy	p h u y |
bồm	b ồ m |
trội	t r ộ i |
chuyên	c h u y ê n |
dạvậy	d ạ v ậ y |
đảo	đ ả o |
barrel	b a r r e l |
kwanza	k w a n z a |
menthol	m e n t h o l |
nhèo	n h è o |
gỏi	g ỏ i |
lơn	l ơ n |
dột	d ộ t |
formaldehyd	f o r m a l d e h y d |
phạ	p h ạ |
địt	đ ị t |
kíp	k í p |
mu	m u |
krông	k r ô n g |
nhẹt	n h ẹ t |
tướt	t ư ớ t |
kg	k g |
rầm	r ầ m |
chuẩn	c h u ẩ n |
phứt	p h ứ t |
bọng	b ọ n g |
mẵm	m ẵ m |
catsê	c a t s ê |
taka	t a k a |
đúm	đ ú m |
đỏng	đ ỏ n g |
nhạp	n h ạ p |
nòm	n ò m |
mứn	m ứ n |
ngự	n g ự |
thuồn	t h u ồ n |
thó	t h ó |
oản	o ả n |
gù	g ù |
sụa	s ụ a |
nhạo	n h ạ o |
cườm	c ư ờ m |
èng	è n g |
xắng	x ắ n g |
clinker	c l i n k e r |
manat	m a n a t |
chướng	c h ư ớ n g |
êcle	ê c l e |
dặm	d ặ m |
dòm	d ò m |
phới	p h ớ i |
hưấn	h ư ấ n |
cari	c a r i |
cơn	c ơ n |
yôga	y ô g a |
ngheo	n g h e o |
ozone	o z o n e |
biếc	b i ế c |
uột	u ộ t |
ghín	g h í n |
phan	p h a n |
tuýt	t u ý t |
rẩm	r ẩ m |
giô	g i ô |
hẹm	h ẹ m |
mual	m u a l |
jeep	j e e p |
khuân	k h u â n |
héo	h é o |
thịnh	t h ị n h |
lài	l à i |
picnic	p i c n i c |
brâu	b r â u |
nặn	n ặ n |
nở	n ở |
lưu	l ư u |
ngoằn	n g o ằ n |
ư	ư |
tuông	t u ô n g |
phênh	p h ê n h |
dệ	d ệ |
bươi	b ư ơ i |
xứng	x ứ n g |
đém	đ é m |
pàng	p à n g |
nhẽ	n h ẽ |
cặp	c ặ p |
lên	l ê n |
âởu	â ở u |
lườn	l ư ờ n |
nghiêu	n g h i ê u |
ôn	ô n |
trỏi	t r ỏ i |
nhóe	n h ó e |
thẩy	t h ẩ y |
quình	q u ì n h |
bạt	b ạ t |
thọ	t h ọ |
rề	r ề |
lạp	l ạ p |
xiphông	x i p h ô n g |
hoặcsố	h o ặ c s ố |
rợi	r ợ i |
nót	n ó t |
đổ	đ ổ |
k	k |
xỡ	x ỡ |
nấu	n ấ u |
rồ	r ồ |
greenland	g r e e n l a n d |
giẹo	g i ẹ o |
chiện	c h i ệ n |
ang	a n g |
yuan	y u a n |
đại	đ ạ i |
dó	d ó |
dìu	d ì u |
tịnh	t ị n h |
buôn	b u ô n |
nhoàm	n h o à m |
mốt	m ố t |
tấy	t ấ y |
vũng	v ũ n g |
nheo	n h e o |
vần	v ầ n |
núa	n ú a |
bõ	b õ |
polyethylene	p o l y e t h y l e n e |
cửu	c ử u |
hiểm	h i ể m |
tẻm	t ẻ m |
nam	n a m |
bôbin	b ô b i n |
khước	k h ư ớ c |
ôsin	ô s i n |
rột	r ộ t |
đún	đ ú n |
bệch	b ệ c h |
rệt	r ệ t |
giảnh	g i ả n h |
hặc	h ặ c |
săngta	s ă n g t a |
cuồn	c u ồ n |
xtrích	x t r í c h |
lại	l ạ i |
viêng	v i ê n g |
ngảo	n g ả o |
buôi	b u ô i |
ruôn	r u ô n |
mỏ	m ỏ |
dura	d u r a |
manh	m a n h |
bhing	b h i n g |
xtiêng	x t i ê n g |
on	o n |
thổn	t h ổ n |
thoáng	t h o á n g |
ngoèo	n g o è o |
lúc	l ú c |